ChunkX,ChunkY,TerrainTime(ms),ModificationTime(ms),FaceTime(ms),MeshTime(ms),TotalTime(ms)
48,16,345,0,1056,776,2177
32,-48,382,0,1159,921,2462
64,0,361,0,1173,937,2471
0,-32,298,0,1241,991,2530
-48,16,299,0,1380,937,2616
0,16,361,19,1220,1032,2632
-16,32,361,0,1309,1043,2713
48,32,299,0,1377,1053,2729
16,-32,417,0,1211,1106,2734
0,0,518,0,1073,1205,2796
16,-64,296,0,1444,1158,2898
32,0,483,0,1268,1155,2906
16,32,364,0,1510,1081,2955
16,16,314,0,1497,1159,2970
-32,-64,443,0,1377,1173,2993
-32,16,416,0,1402,1208,3026
16,64,345,0,1476,1235,3056
64,16,381,0,1481,1203,3065
-32,-32,282,0,1473,1357,3112
-16,-48,480,0,1370,1263,3113
32,16,282,0,1685,1151,3118
16,-48,378,0,1486,1253,3117
-16,0,553,0,1153,1457,3163
-16,-64,380,0,1426,1359,3165
-48,32,382,0,1475,1313,3170
-32,-48,245,33,1675,1281,3234
32,32,482,0,1426,1342,3250
48,0,297,0,1660,1342,3299
-16,-16,432,3,1525,1452,3412
48,-32,555,0,1598,1327,3480
0,-64,377,0,1490,1615,3482
-16,-32,529,8,1589,1368,3494
0,64,428,0,1747,1323,3498
32,-64,361,0,1706,1492,3559
-64,-32,516,0,1658,1431,3605
-48,-16,482,0,1652,1521,3655
32,-32,417,0,1887,1453,3757
-32,-16,634,0,1567,1561,3762
32,48,446,0,1705,1668,3819
-48,-32,599,0,1983,1346,3928
-16,16,539,6,1934,1583,4062
-32,64,412,0,2061,1675,4148
32,-16,556,0,2096,1510,4162
64,32,21,0,1240,844,2105
-64,-64,16,0,883,1019,1918
-64,-48,82,0,1134,938,2154
0,-48,582,0,2538,1835,4955
32,32,28,0,928,974,1930
-64,48,20,0,1231,1266,2517
-48,64,66,0,1418,983,2467
48,64,20,0,1345,1042,2407
48,32,71,0,809,903,1783
64,-48,58,0,1384,1074,2516
64,48,67,0,1281,1078,2426
0,-16,381,0,2531,2361,5273
0,32,636,0,2668,2057,5361
16,48,56,0,1228,1007,2291
-48,-64,37,0,1426,1378,2841
32,16,73,0,1164,986,2223
-64,0,442,0,2610,2375,5427
64,64,95,0,1395,999,2489
16,32,41,0,1209,1169,2419
32,48,19,0,1114,1159,2292
-64,16,428,0,2927,2101,5456
48,16,45,0,961,1028,2034
16,16,20,0,1232,1217,2469
16,64,45,0,1128,1110,2283
64,-64,55,0,1371,1249,2675
-32,32,581,0,2909,2239,5729
-48,0,482,0,3169,2081,5732
48,-64,103,1,1352,1581,3037
48,0,43,0,1075,1090,2208
0,48,531,0,3012,2395,5938
-64,64,56,0,1740,1298,3094
-64,32,496,0,3160,2382,6038
16,0,93,0,1300,1310,2703
16,-16,687,0,3215,2201,6103
0,32,15,0,1525,1429,2969
48,-16,601,0,3164,2398,6163
16,0,554,0,3327,2321,6202
16,48,344,0,3494,2376,6214
0,48,52,0,1429,1492,2973
-32,0,500,0,3350,2483,6333
0,16,49,5,1640,1392,3086
-16,32,37,0,1779,1269,3085
0,64,16,0,1639,1238,2893
48,48,579,0,2742,3154,6475
32,64,66,0,1526,1427,3019
48,64,61,0,1331,1287,2679
-48,-48,552,0,3409,2588,6549
64,-16,515,0,3646,2406,6567
48,-48,632,0,3307,2715,6654
32,0,50,0,1702,1475,3227
64,48,120,0,954,850,1924
0,0,101,0,1565,1659,3325
16,80,53,0,1473,1405,2931
0,80,16,0,1055,836,1907
64,-32,660,0,3485,2636,6781
32,80,52,0,1229,1219,2500
64,32,58,0,1501,1085,2644
-32,48,635,0,3836,2382,6853
-16,16,105,0,1759,1510,3374
16,-16,41,0,1605,1310,2956
48,48,57,0,1306,1933,3296
-16,0,48,0,1543,1655,3246
64,16,57,0,1144,729,1930
-16,48,632,0,3374,2939,6945
-16,48,90,0,1803,1513,3406
-48,48,656,0,3351,2976,6983
-32,32,61,0,1512,1358,2931
32,64,597,0,3922,2502,7021
64,0,61,0,1142,636,1839
-16,64,78,0,1806,1389,3273
-64,-16,556,0,3966,2594,7116
-32,16,58,0,1162,912,2132
-32,48,53,0,1728,1218,2999
-16,-16,81,0,1130,919,2130
32,-16,30,0,1596,648,2274
-16,64,595,0,4101,2648,7344
80,48,49,0,1147,561,1757
80,16,56,0,1223,471,1750
-48,48,50,1,1226,487,1764
0,96,23,0,1113,749,1885
-32,0,29,0,1594,550,2173
-16,80,106,0,1491,931,2528
-48,32,96,0,1101,925,2122
16,-32,19,0,1203,879,2101
80,64,21,0,953,393,1367
80,96,45,0,577,319,941
48,-16,67,0,1504,947,2518
64,96,38,0,903,352,1293
80,32,28,0,1357,783,2168
32,-32,28,0,1307,767,2102
48,-32,25,0,1157,368,1550
-32,96,41,1,936,396,1374
-32,64,56,0,1525,823,2404
-32,-32,48,0,962,370,1380
64,80,97,0,1275,578,1950
64,-16,23,0,1260,565,1848
-32,-16,31,0,1523,563,2117
80,-32,43,0,849,319,1211
-48,64,22,0,1376,421,1819
0,-32,55,0,1644,696,2395
64,-32,57,0,1076,281,1414
-48,-16,38,0,1080,335,1453
0,-16,75,0,2070,925,3070
64,64,79,0,2177,457,2713
48,80,74,0,2070,660,2804
16,96,50,4,2087,480,2621
-48,16,75,0,2046,303,2424
32,96,74,0,2125,287,2486
-16,-32,70,0,1706,289,2065
80,0,92,0,1770,273,2135
-16,96,89,0,1579,333,2001
-48,96,93,0,1209,273,1575
-48,0,97,0,1582,280,1959
48,96,145,0,1529,330,2004
80,80,82,5,1308,240,1635
-48,80,46,0,1532,320,1898
-32,80,74,0,1941,313,2328
80,-16,132,0,1437,205,1774
-48,-32,84,0,1361,206,1651
96,96,27,0,173,132,332
96,80,44,0,185,146,375
96,0,41,0,196,157,394
96,64,27,0,212,159,398
96,32,43,0,221,146,410
96,16,43,0,230,159,432
96,48,42,0,218,188,448
96,-32,54,0,222,174,450
96,-16,78,0,243,128,449
-64,-64,6,0,38,10,54
-80,-64,24,0,138,68,230
-80,-48,30,0,174,109,313
-80,64,27,0,184,119,330
-80,-16,42,0,220,130,392
-80,32,43,0,220,131,394
-80,48,41,0,224,132,397
-80,0,42,0,229,127,398
-80,-32,43,0,272,86,401
-80,16,44,0,281,78,403
-64,80,6,0,43,19,68
-64,96,6,0,22,19,47
-64,112,13,0,151,102,266
-32,112,22,0,169,138,329
-16,112,18,0,151,165,334
-48,112,30,0,154,156,340
0,112,39,0,150,161,350
64,112,38,0,159,153,350
16,112,40,0,187,129,356
48,112,40,0,190,128,358
32,112,42,0,220,99,361
64,128,19,0,147,106,272
-64,128,20,0,153,145,318
48,128,20,0,173,158,351
-32,128,36,0,181,144,361
0,128,35,0,186,142,363
-48,128,35,0,188,142,365
-16,128,25,0,200,141,366
32,128,22,0,206,153,381
16,128,36,0,192,153,381
64,144,18,0,123,78,219
48,144,20,0,145,100,265
-64,144,21,0,164,134,319
32,144,19,0,179,138,336
-48,144,19,0,206,124,349
0,144,21,0,206,124,351
16,144,35,0,216,117,368
-16,144,36,0,221,112,369
-32,144,35,0,231,104,370
80,144,18,0,65,38,121
80,128,19,0,79,35,133
80,112,19,0,78,51,148
80,96,20,0,100,45,165
96,144,18,0,113,69,200
96,128,20,0,115,108,243
96,112,25,0,120,100,245
96,80,20,0,124,103,247
96,96,20,0,121,106,247
96,64,21,0,144,83,248
112,96,22,0,147,112,281
112,112,37,0,134,171,342
112,64,23,0,159,161,343
112,0,36,0,162,149,347
112,80,36,0,165,150,351
112,48,37,0,200,130,367
112,32,24,0,182,162,368
112,128,24,0,186,157,367
112,16,38,0,217,115,370
128,96,24,0,140,128,292
128,0,54,0,134,126,314
128,112,25,0,164,133,322
128,64,24,0,170,130,324
128,80,47,0,188,128,363
128,16,25,0,209,132,366
128,32,53,0,196,119,368
128,128,26,0,199,144,369
128,48,55,0,202,112,369
112,144,13,0,44,19,76
128,144,13,0,47,18,78
144,144,19,0,134,80,233
144,128,20,0,161,121,302
144,80,32,0,177,128,337
144,16,32,0,176,142,350
144,96,33,0,173,145,351
144,64,43,0,166,143,352
144,112,32,0,198,124,354
144,32,36,0,207,114,357
144,48,53,0,230,73,356
48,160,19,0,132,103,254
32,160,19,0,139,124,282
64,160,32,0,148,136,316
80,160,32,0,155,148,335
96,160,32,0,153,150,335
16,160,25,0,177,136,338
144,160,34,0,181,125,340
112,160,19,0,168,154,341
128,160,32,0,186,124,342
160,144,23,0,144,143,310
160,128,6,0,162,146,314
160,96,21,0,154,154,329
160,80,20,0,157,154,331
160,160,22,0,155,158,335
160,112,11,0,167,158,336
160,64,20,0,180,137,337
160,32,22,0,212,117,351
160,48,23,0,221,108,352
48,176,22,0,151,137,310
32,176,18,0,153,162,333
96,176,32,0,150,152,334
112,176,32,0,170,142,344
144,176,33,0,176,158,367
80,176,33,0,203,134,370
64,176,34,0,205,132,371
128,176,32,0,203,137,372
160,176,33,0,212,128,373
112,192,17,0,160,145,322
96,192,16,0,170,148,334
128,192,31,0,171,154,356
144,192,30,0,183,166,379
80,192,31,0,183,168,382
48,192,42,0,180,161,383
160,192,31,0,190,164,385
64,192,31,0,184,171,386
32,192,32,0,181,173,386
16,192,5,0,35,18,58
16,176,5,0,35,20,60
112,208,21,0,167,123,311
144,208,46,0,165,161,372
32,208,22,0,186,167,375
96,208,22,0,206,149,377
128,208,46,0,165,167,378
64,208,57,0,182,144,383
48,208,47,0,163,174,384
80,208,46,0,200,149,395
160,208,46,0,194,155,395
48,224,31,0,141,136,308
112,224,19,0,161,148,328
128,224,34,0,171,134,339
64,224,32,0,170,138,340
32,224,32,0,172,137,341
96,224,33,0,169,154,356
80,224,23,0,188,148,359
144,224,34,0,203,122,359
160,224,32,0,202,125,359
16,208,6,0,50,19,75
16,224,7,0,52,20,79
64,240,19,0,142,141,302
112,240,19,0,142,141,302
128,240,19,0,153,134,306
80,240,19,0,142,155,316
16,240,18,0,152,152,322
96,240,36,0,133,156,325
144,240,20,0,165,140,325
32,240,19,0,166,141,326
48,240,31,0,150,145,326
64,256,17,0,135,138,290
48,256,17,0,149,145,311
128,256,19,0,162,132,313
32,256,17,0,150,146,313
144,256,18,0,151,162,331
112,256,18,0,151,162,331
80,256,19,0,161,152,332
96,256,29,0,149,155,333
16,256,29,0,183,122,334
160,256,16,0,44,28,88
160,240,17,0,63,14,94
176,160,19,0,155,149,323
176,240,20,0,159,150,329
176,144,33,0,143,153,329
176,256,20,0,150,164,334
176,176,21,0,151,172,344
176,192,35,0,167,151,353
176,128,34,0,168,150,352
176,224,34,0,174,147,355
176,208,34,0,207,117,358
48,272,55,0,124,144,323
64,272,28,0,152,159,339
144,272,17,0,164,165,346
112,272,41,0,160,147,348
128,272,29,0,173,148,350
80,272,28,0,175,147,350
160,272,28,0,156,171,355
96,272,29,0,174,163,366
176,272,49,6,134,177,366
192,192,15,0,122,103,240
192,176,17,0,147,127,291
192,160,18,0,146,135,299
192,256,15,0,150,135,300
192,272,16,0,154,144,314
192,240,16,0,157,142,315
192,144,29,0,168,121,318
192,208,31,0,164,124,319
192,224,30,0,180,109,319
208,176,17,0,120,90,227
208,192,18,0,142,124,284
208,272,19,0,136,135,290
208,256,19,0,139,144,302
208,160,18,0,143,144,305
208,240,20,0,168,146,334
208,208,20,0,201,115,336
208,224,21,0,204,111,336
208,144,29,0,194,112,335
192,128,6,0,58,23,87
208,128,6,0,59,23,88
224,256,35,5,128,105,273
224,176,42,0,146,144,332
224,192,43,0,172,147,362
224,160,35,0,176,152,363
224,128,42,0,189,132,363
224,240,42,0,178,145,365
224,144,43,0,177,146,366
224,224,49,1,190,128,368
224,208,44,0,202,123,369
176,112,9,0,111,22,142
192,112,11,0,131,20,162
208,112,11,0,133,21,165
80,96,10,0,88,22,120
176,96,18,0,90,20,128
192,96,21,0,122,20,163
208,96,20,0,124,20,164
224,96,20,0,53,25,98
224,112,20,0,55,23,98
240,128,19,0,155,148,322
240,112,18,0,157,148,323
240,224,29,0,152,148,329
240,160,19,0,155,157,331
240,144,31,0,167,135,333
240,96,18,0,174,142,334
240,176,31,0,173,146,350
240,192,31,0,199,123,353
240,208,30,0,178,145,353
0,-48,84,5,550,460,1099
0,-16,181,0,408,562,1151
16,16,146,0,578,492,1216
32,-32,195,0,510,589,1294
-16,32,143,0,602,562,1307
0,48,206,1,468,643,1318
-32,32,179,0,526,616,1321
16,-32,115,0,568,667,1350
0,32,150,0,553,699,1402
0,0,146,0,539,742,1427
32,32,113,0,662,698,1473
16,-16,229,0,674,603,1506
-16,16,158,22,729,687,1596
16,0,197,0,796,664,1657
-32,-32,189,0,840,824,1853
48,16,42,0,632,514,1188
-48,16,73,0,652,549,1274
16,48,88,0,634,564,1286
-16,-48,68,0,700,552,1320
32,-16,227,0,1018,811,2056
0,-32,145,0,954,1066,2165
48,-16,82,0,746,648,1476
-32,48,80,5,822,672,1579
48,32,31,0,532,529,1092
32,-48,30,0,614,555,1199
-32,-48,70,0,771,595,1436
-48,32,38,0,609,559,1206
-16,48,70,0,908,863,1841
48,-32,38,0,765,662,1465
32,16,112,0,1481,1027,2620
64,16,49,0,605,534,1188
64,0,43,0,688,580,1311
32,48,52,0,771,736,1559
0,64,31,0,805,616,1452
0,16,146,44,1399,1304,2893
16,32,196,0,1576,1146,2918
-64,0,60,0,774,723,1557
-48,0,145,0,1440,1338,2923
-48,-32,35,0,938,788,1761
0,-64,30,0,826,786,1642
32,0,190,0,1672,1304,3166
-16,-64,38,0,784,748,1570
-64,16,26,0,623,548,1197
16,-64,34,0,793,712,1539
-16,-32,221,0,1642,1339,3202
-32,16,157,0,1619,1484,3260
16,-48,63,0,1387,1108,2558
-32,0,196,0,1697,1492,3385
-16,-16,191,0,1623,1656,3470
48,0,91,0,1405,1300,2796
64,-16,62,0,869,714,1645
16,64,33,0,834,677,1544
-64,-16,79,0,800,637,1516
-48,48,37,0,757,661,1455
-16,64,36,0,1026,742,1804
-64,32,46,0,662,543,1251
-32,-16,195,0,1966,1575,3736
-48,-48,57,0,836,796,1689
-16,0,266,0,1792,1693,3751
48,-48,40,0,796,685,1521
64,32,37,0,619,497,1153
-32,-64,42,0,763,553,1358
64,-32,65,0,830,612,1507
32,-64,30,0,711,637,1378
64,48,14,0,538,461,1013
32,64,54,0,840,621,1515
-64,48,41,0,673,783,1497
-32,64,52,0,936,727,1715
-48,64,16,0,782,667,1465
-48,-64,33,0,743,694,1470
64,64,16,0,642,507,1165
-48,-16,116,0,1937,1728,3781
-64,-64,29,0,608,772,1409
-64,-48,36,0,846,707,1589
176,160,24,2,711,643,1380
64,-64,59,0,741,662,1462
208,160,12,0,550,508,1070
160,144,31,0,587,495,1113
208,176,11,0,449,413,873
176,192,25,0,643,556,1224
176,128,32,0,634,536,1202
144,144,33,0,567,461,1061
144,160,51,0,727,639,1417
160,176,25,0,845,733,1603
160,192,32,0,650,568,1250
144,176,20,0,612,604,1236
192,128,35,0,724,653,1412
208,144,38,0,672,625,1335
208,128,14,0,636,541,1191
144,192,33,0,555,547,1135
144,128,32,0,645,563,1240
48,48,45,0,1374,1833,3252
208,192,31,0,620,631,1282
128,160,41,0,620,564,1225
48,64,49,0,1554,1217,2820
176,208,34,0,738,715,1487
224,176,15,0,568,650,1233
160,112,29,0,566,608,1203
176,112,35,0,748,735,1518
192,176,46,0,1308,1119,2473
-64,-32,85,0,1922,1317,3324
192,160,68,0,1410,1274,2752
128,144,19,0,573,556,1148
192,208,32,0,712,694,1438
224,144,21,0,669,640,1330
144,208,14,0,599,508,1121
160,208,33,0,738,641,1412
128,176,35,0,738,735,1508
192,192,71,0,1028,1211,2310
176,176,40,0,1313,1475,2828
176,144,48,0,1419,1381,2848
144,112,35,0,686,553,1274
64,-48,51,0,1838,1423,3312
160,160,66,0,1501,1307,2874
192,112,35,0,705,639,1379
224,192,47,3,597,548,1195
160,128,87,0,1428,1177,2692
192,144,56,0,1582,1294,2932
48,-64,87,0,1503,1870,3460
224,128,16,0,756,591,1363
-64,64,129,0,1862,1361,3352
128,192,13,0,742,578,1333
208,208,33,0,736,631,1400
112,160,41,0,624,616,1281
128,128,48,0,740,634,1422
240,160,39,0,623,592,1254
176,224,41,0,674,603,1318
160,96,16,0,629,513,1158
208,112,42,0,853,743,1638
160,224,16,0,742,361,1119
240,128,35,0,563,279,877
112,176,16,0,551,518,1085
240,176,43,0,768,614,1425
144,96,19,0,612,306,937
112,192,21,0,515,433,969
240,144,38,0,739,463,1240
192,224,59,0,761,424,1244
224,160,45,0,1545,1050,2640
128,96,14,0,515,340,869
224,208,15,0,721,415,1151
240,224,33,0,346,208,587
224,112,40,0,744,415,1199
240,192,40,0,674,441,1155
240,96,33,0,482,289,804
208,96,49,0,824,381,1254
224,224,26,0,593,392,1011
112,224,35,0,515,321,871
176,96,76,0,1450,501,2027
128,112,51,0,1149,322,1522
112,144,46,0,1180,332,1558
128,208,47,0,1118,366,1531
192,96,63,0,1387,384,1834
128,224,66,2,913,324,1305
112,96,93,0,708,259,1060
240,112,75,0,746,328,1149
240,208,35,0,631,457,1123
112,208,47,0,938,367,1352
144,224,64,0,1064,350,1478
112,112,73,0,738,359,1170
208,224,49,0,1131,277,1457
112,128,37,0,1149,248,1434
224,96,47,0,872,238,1157
240,240,7,0,147,150,304
128,240,8,0,167,136,311
192,240,7,0,168,143,318
112,240,21,0,158,151,330
176,240,7,0,187,155,349
144,240,21,0,178,152,351
224,240,23,0,217,119,359
160,240,22,0,207,139,368
208,240,22,0,175,173,370
96,176,21,0,150,140,311
96,192,17,0,156,160,333
96,144,28,0,164,144,336
96,240,28,0,159,151,338
96,160,28,0,162,147,337
96,112,29,0,193,145,367
96,128,28,0,175,169,372
96,208,28,0,195,149,372
96,224,30,0,192,152,374
224,256,14,0,139,134,287
240,256,15,0,141,132,288
208,256,16,0,158,141,315
144,256,16,0,158,149,323
192,256,16,0,169,140,325
128,256,27,0,178,147,352
112,256,16,0,166,171,353
160,256,28,0,178,148,354
176,256,27,0,161,167,355
96,256,5,0,33,16,54
208,272,17,0,165,141,323
224,272,19,0,167,143,329
144,272,19,0,188,149,356
192,272,19,0,189,150,358
160,272,41,0,163,154,358
112,272,19,0,195,146,360
128,272,43,0,174,144,361
240,272,17,0,193,151,361
176,272,41,0,164,160,365
256,256,16,0,130,117,263
256,240,29,0,162,140,331
256,272,29,0,165,150,344
256,224,30,0,187,130,347
256,176,29,0,159,172,360
256,144,28,0,184,165,377
256,160,29,0,190,158,377
256,192,29,0,188,161,378
256,208,30,0,197,151,378
176,288,31,0,120,124,275
160,288,19,0,145,120,284
192,288,33,0,148,134,315
208,288,33,0,169,133,335
144,288,32,0,174,132,338
128,288,33,0,195,116,344
224,288,32,0,169,145,346
240,288,44,0,198,120,362
256,288,45,0,240,87,372
272,256,18,0,145,117,280
272,192,28,0,158,159,345
272,240,28,0,160,159,347
272,208,49,0,169,136,354
272,272,28,0,160,177,365
272,176,29,0,155,182,366
272,224,35,0,189,144,368
272,288,50,0,175,148,373
272,160,51,0,215,109,375
176,304,6,0,128,94,228
144,304,19,0,137,106,262
160,304,9,0,134,121,264
192,304,19,0,145,122,286
208,304,21,0,169,113,303
224,304,20,0,181,134,335
240,304,20,0,212,105,337
272,304,22,0,213,104,339
256,304,21,0,215,104,340
288,256,19,0,123,63,205
288,272,20,0,157,125,302
288,288,20,0,159,131,310
288,240,21,0,173,117,311
288,304,33,0,177,120,330
288,224,35,0,190,112,337
288,208,37,0,240,89,366
288,192,36,0,214,116,366
288,176,37,0,233,97,367
0,-32,70,16,256,176,518
16,16,83,4,404,284,775
16,32,118,0,365,296,779
0,16,145,0,378,335,858
-16,-16,107,11,404,343,865
0,0,145,0,382,394,921
-32,0,143,0,517,348,1008
16,-16,145,0,498,381,1024
-16,0,169,0,465,406,1040
32,-16,143,0,531,366,1040
-32,-16,168,0,526,351,1045
32,16,24,0,374,247,645
16,-32,136,0,506,533,1175
0,32,105,0,535,560,1200
0,-16,96,0,539,571,1206
-16,-32,94,0,608,554,1256
-16,32,106,0,672,536,1314
-32,16,113,0,774,546,1433
16,0,171,0,727,549,1447
32,0,144,0,803,581,1528
32,32,21,0,372,280,673
32,-32,30,0,465,283,778
-16,16,145,0,815,654,1614
-32,32,30,0,426,334,790
0,-48,27,0,351,273,651
-48,16,29,0,361,290,680
0,48,28,0,420,366,814
48,0,42,1,348,308,699
48,16,9,0,342,231,582
16,48,34,0,361,293,688
-32,-32,30,0,555,407,992
-48,0,30,0,456,275,761
32,-48,25,0,334,254,613
-48,32,15,2,338,297,652
32,48,50,0,384,311,745
16,-48,50,0,549,418,1017
64,16,25,0,331,216,572
64,0,24,0,322,273,619
-64,0,37,0,359,322,718
0,64,23,0,372,309,704
16,-64,58,0,344,299,701
0,-64,33,0,399,359,791
-16,-48,62,0,726,583,1371
-48,-32,62,0,483,368,913
48,32,29,0,438,509,976
-16,48,61,0,735,637,1433
-16,-64,56,0,409,380,845
48,-16,67,0,757,620,1444
-32,-48,56,0,727,524,1307
-48,-16,35,0,860,644,1539
48,-32,34,0,709,523,1266
-32,48,31,0,829,532,1392
-64,16,12,0,372,222,606
-16,64,30,0,495,283,808
-48,-48,51,0,381,287,719
64,-16,32,0,465,303,800
48,48,11,0,333,341,685
-64,-16,45,0,472,318,835
-48,48,27,0,441,283,751
48,-48,50,0,399,307,756
-32,-64,39,0,414,304,757
64,-32,45,0,480,278,803
32,64,59,0,455,314,828
16,64,32,0,695,507,1234
48,64,25,0,384,275,684
64,48,43,0,299,227,569
-64,32,28,0,620,514,1162
-64,-64,10,0,257,321,588
64,-48,24,0,457,342,823
-64,-48,16,0,363,318,697
32,-64,30,0,650,536,1216
64,32,25,0,558,482,1065
48,-64,24,0,368,427,819
-48,-64,32,0,601,538,1171
64,64,24,0,354,283,661
-64,64,22,0,418,338,778
176,160,16,0,334,295,645
-64,-32,43,0,764,589,1396
-32,64,47,0,785,608,1440
192,160,26,0,323,269,618
64,-64,24,0,478,332,834
-64,48,35,1,609,711,1356
-48,64,39,0,716,599,1354
176,144,14,0,355,240,609
192,144,18,0,374,221,613
160,160,40,0,365,303,708
160,144,11,0,350,258,619
160,176,13,0,413,273,699
192,192,22,0,242,255,519
144,160,26,0,387,292,705
160,128,42,0,375,236,653
192,176,23,0,565,434,1022
192,128,34,0,390,324,748
176,176,51,0,568,620,1239
144,176,41,0,353,344,738
160,192,37,0,396,340,773
208,160,25,0,575,474,1074
144,128,46,0,362,263,671
208,192,23,0,293,239,555
144,192,35,0,323,249,607
208,176,29,0,412,405,846
176,192,33,0,656,525,1214
144,144,26,0,548,465,1039
176,208,27,0,401,316,744
128,160,16,0,352,274,642
176,112,21,0,402,299,722
176,128,48,0,631,564,1243
208,128,41,0,601,468,1110
208,144,29,0,684,519,1232
224,160,27,0,376,280,683
128,176,47,0,355,292,694
224,176,24,0,290,279,593
160,112,13,0,364,295,672
224,144,47,0,378,297,722
144,208,29,0,368,209,606
192,112,26,0,439,276,741
144,112,38,0,367,249,654
224,192,49,0,339,269,657
128,192,26,0,307,281,614
192,208,29,0,583,481,1093
128,128,13,0,365,303,681
128,144,30,0,618,468,1116
176,96,26,0,362,294,682
160,96,24,0,353,277,654
240,176,26,0,335,309,670
160,208,31,0,691,552,1274
224,128,54,0,626,413,1093
240,144,24,0,327,256,607
112,176,13,0,335,244,592
192,224,27,0,333,254,614
192,96,28,0,415,323,766
112,160,29,0,511,529,1069
160,224,28,0,411,338,777
208,112,35,0,742,554,1331
208,208,20,0,679,582,1281
240,160,46,0,531,520,1097
112,144,12,0,349,239,600
128,112,29,0,338,246,613
176,224,57,0,604,575,1236
128,208,29,0,352,260,641
240,128,29,0,318,228,575
112,192,10,0,312,239,561
144,96,31,0,341,243,615
208,224,29,0,364,247,640
112,128,25,0,351,232,608
112,208,22,0,308,274,604
128,96,11,0,303,241,555
240,192,28,0,366,302,696
224,208,34,0,708,390,1132
224,112,36,0,632,380,1048
224,96,29,0,336,283,648
144,224,29,0,625,320,974
112,224,24,0,265,260,549
128,224,53,0,531,216,800
240,112,14,0,475,210,699
208,96,37,0,724,272,1033
112,96,28,0,393,178,599
112,112,15,0,423,268,706
240,224,14,0,319,194,527
240,96,22,0,326,190,538
240,208,14,0,368,302,684
224,224,20,0,555,180,755
176,80,19,0,156,122,297
160,80,31,0,156,140,327
112,80,30,0,153,149,332
240,80,18,0,166,149,333
128,80,33,0,179,136,348
144,80,33,0,183,136,352
224,80,33,0,204,119,356
192,80,33,0,184,140,357
208,80,34,0,216,108,358
256,128,21,0,135,90,246
256,96,20,0,157,130,307
256,112,21,0,156,137,314
256,176,34,0,150,157,341
256,80,22,0,189,131,342
256,144,35,0,175,137,347
256,192,20,0,186,140,346
256,160,22,0,188,137,347
256,208,22,0,192,138,352
128,64,20,0,172,137,329
112,64,33,0,147,154,334
144,64,32,0,165,141,338
240,64,33,0,164,153,350
224,64,34,0,170,151,355
176,64,34,0,169,152,355
160,64,57,0,148,153,358
208,64,33,0,191,135,359
192,64,48,0,182,131,361
112,48,38,0,150,102,290
128,48,40,0,173,117,330
224,48,40,0,158,137,335
240,48,45,0,177,123,345
144,48,51,0,196,135,382
160,48,54,0,189,140,383
192,48,57,0,203,125,385
208,48,52,0,195,139,386
176,48,52,0,176,158,386
256,48,8,0,54,18,80
256,64,10,0,75,6,91
256,32,52,0,124,180,356
192,32,22,0,181,158,361
128,32,51,0,180,143,374
224,32,38,0,212,132,382
208,32,51,0,179,165,395
144,32,51,0,203,144,398
160,32,50,0,182,166,398
176,32,50,0,172,177,399
240,32,43,0,218,138,399
16,-32,128,1,482,464,1075
48,0,131,0,515,445,1091
48,16,129,9,488,539,1165
0,-48,113,15,541,539,1208
16,32,132,0,577,537,1246
-16,-32,159,0,526,585,1270
32,16,225,0,610,516,1351
0,48,156,0,561,741,1458
16,16,251,0,591,651,1493
-32,32,198,0,722,603,1523
-48,16,158,0,740,662,1560
-32,16,198,0,643,723,1564
0,32,171,0,797,699,1667
-16,-16,224,9,662,790,1685
0,16,127,31,761,787,1706
16,48,103,25,860,722,1710
-16,0,259,0,726,812,1797
0,0,178,0,811,892,1881
16,-48,45,0,586,540,1171
-32,-32,201,0,858,879,1938
0,-32,128,13,939,984,2064
32,-16,252,0,1051,776,2079
-16,16,272,0,1072,898,2242
0,-16,209,0,993,1103,2305
48,32,34,1,468,552,1055
-16,48,51,0,839,682,1572
-48,-16,86,0,845,679,1610
-48,32,32,0,554,534,1120
32,-48,33,0,678,592,1303
-32,-48,61,0,743,622,1426
48,-32,44,0,750,636,1430
32,48,62,0,685,641,1388
-48,0,198,0,1376,1039,2613
32,-32,197,0,1259,1161,2617
-32,48,83,0,1017,835,1935
32,32,221,0,1339,1157,2717
64,0,18,0,615,594,1227
0,64,36,0,645,582,1263
64,16,43,0,613,515,1171
16,-16,211,0,1382,1202,2795
-64,0,38,0,658,646,1342
-32,0,225,0,1530,1160,2915
-64,16,34,0,562,567,1163
16,-64,34,0,616,613,1263
32,0,210,0,1592,1204,3006
-48,-32,36,0,906,775,1717
16,0,225,0,1572,1281,3078
-32,-16,211,0,1622,1288,3121
-16,32,128,16,1647,1369,3160
0,-64,59,0,852,866,1777
64,-16,65,0,897,701,1663
-16,-64,32,0,893,796,1721
-64,-16,40,0,837,639,1516
-64,32,38,0,612,538,1188
16,64,36,0,888,709,1633
-48,-48,17,0,905,749,1671
-16,-48,123,0,1449,1316,2888
64,32,15,0,641,433,1089
48,-16,112,0,1439,1361,2912
32,-64,29,0,758,583,1370
-16,64,61,8,1081,890,2040
-48,48,36,0,873,779,1688
-32,-64,34,0,800,643,1477
-32,64,63,0,765,637,1465
48,-48,20,0,865,734,1619
-64,-32,41,0,803,606,1450
64,48,16,0,637,517,1170
32,64,37,0,837,627,1501
-64,48,16,0,681,748,1445
64,64,34,0,604,511,1149
-64,-48,14,0,734,621,1369
48,-64,32,0,701,741,1474
48,64,37,0,868,718,1623
-64,64,40,0,842,594,1476
192,96,36,0,833,581,1450
192,112,36,0,750,605,1391
192,128,31,0,615,527,1173
48,48,24,0,1115,1491,2630
176,80,32,0,770,569,1371
224,96,64,0,623,666,1353
-48,-64,59,0,1202,997,2258
-64,-64,55,0,928,1134,2117
160,96,18,0,815,587,1420
64,-32,47,0,1506,1110,2663
208,80,39,0,946,661,1646
176,112,38,0,846,720,1604
224,80,17,0,688,567,1272
208,64,53,0,690,609,1352
160,112,19,0,606,614,1239
224,112,61,0,615,580,1256
160,64,16,0,638,566,1220
160,80,35,0,786,633,1454
192,144,60,0,566,559,1185
160,128,34,0,649,587,1270
176,128,30,0,704,752,1486
224,128,27,0,696,577,1300
144,96,32,0,617,587,1236
176,96,55,2,1177,1039,2273
-48,64,58,0,1518,1196,2772
192,48,37,0,704,558,1299
224,64,51,0,793,700,1544
192,64,20,0,934,856,1810
240,96,61,0,575,565,1201
64,-48,51,0,1627,1157,2835
208,144,32,0,683,566,1281
240,112,33,0,638,515,1186
176,144,19,0,620,518,1157
64,-64,47,0,1541,1209,2797
192,80,36,0,1377,1271,2684
144,112,37,0,805,691,1533
208,96,74,0,1598,1276,2948
176,48,38,0,641,613,1292
208,112,48,0,1577,1286,2911
192,160,38,0,492,463,993
208,48,68,0,703,555,1326
176,64,87,0,1396,964,2447
208,128,52,0,1289,1140,2481
256,96,37,0,494,457,988
128,96,51,0,511,549,1111
144,128,18,0,651,480,1149
144,64,68,0,599,519,1186
144,80,37,3,800,646,1486
256,112,36,0,549,500,1085
240,128,33,0,738,600,1371
240,64,18,0,800,589,1407
144,144,27,0,517,481,1025
176,160,38,0,573,569,1180
128,80,31,0,599,464,1094
256,80,37,0,600,534,1171
224,144,40,0,802,703,1545
176,32,17,0,648,621,1286
208,32,63,0,693,563,1319
240,144,35,0,639,521,1195
192,32,42,0,737,653,1432
160,32,38,0,650,375,1063
256,64,37,0,677,402,1116
144,48,50,0,788,480,1318
128,128,37,0,708,410,1155
256,128,12,0,481,316,809
224,160,27,0,679,301,1007
160,144,21,0,1014,920,1955
240,80,21,0,1144,1017,2182
144,160,14,0,492,316,822
240,32,31,0,505,242,778
160,48,44,0,1172,826,2042
128,32,38,0,473,272,783
224,48,44,0,1093,886,2023
208,160,37,0,1029,550,1616
128,48,76,0,480,298,854
128,160,17,0,510,249,776
144,32,38,0,577,303,918
128,112,47,0,1110,503,1660
256,144,24,0,507,338,869
224,32,96,0,992,297,1385
240,48,25,0,1148,371,1544
256,160,64,0,433,235,732
160,160,41,0,1044,252,1337
256,32,32,0,484,260,776
128,64,70,0,912,180,1162
240,160,55,0,816,129,1000
128,144,48,0,876,136,1060
256,48,86,0,779,92,957
208,176,6,0,148,84,238
224,176,5,0,174,140,319
192,176,37,0,163,127,327
176,176,38,0,168,156,362
144,176,30,6,192,141,369
240,176,39,0,200,141,380
128,176,40,0,198,143,381
160,176,37,0,211,133,381
256,176,38,0,197,146,381
192,192,22,0,130,107,259
208,192,32,0,146,117,295
128,192,33,0,167,125,325
144,192,25,0,174,126,325
224,192,33,0,177,150,360
176,192,60,0,152,151,363
160,192,32,0,178,155,365
256,192,33,0,219,116,368
240,192,60,0,198,115,373
192,208,49,0,157,133,339
128,208,49,0,161,156,366
144,208,49,0,176,143,368
208,208,49,0,181,165,395
160,208,50,0,182,163,395
256,208,51,0,208,141,400
224,208,61,0,195,144,400
176,208,51,0,194,155,400
240,208,38,0,192,185,415
112,96,33,0,154,129,316
112,192,32,0,151,137,320
112,112,33,0,135,159,327
112,176,33,0,156,153,342
112,208,33,0,156,154,343
112,160,33,0,157,156,346
112,144,46,0,167,133,346
112,80,46,0,169,132,347
112,128,33,0,189,125,347
0,-32,150,0,684,413,1247
16,-48,268,0,647,491,1406
16,-32,292,0,632,531,1455
48,16,259,0,718,617,1594
-32,32,290,0,723,584,1597
16,32,324,0,724,561,1609
0,-48,215,0,829,628,1672
16,16,307,0,822,627,1756
-48,16,290,0,888,634,1812
-32,16,289,0,854,670,1813
0,16,258,0,792,798,1848
-48,32,135,12,985,743,1875
32,-48,322,0,932,771,2025
-48,0,323,0,991,766,2080
-16,-48,307,0,915,908,2130
32,-32,260,0,1014,879,2153
-48,-32,275,0,1083,803,2161
0,-16,369,0,942,988,2299
0,32,137,11,1252,945,2345
-32,-32,389,0,1021,1026,2436
48,-16,388,0,1168,1031,2587
48,-32,353,6,1296,1013,2668
16,-16,391,0,1261,1021,2673
-64,0,63,0,660,748,1471
-16,48,231,0,1367,1126,2724
16,0,344,0,1417,1011,2772
-32,0,233,0,1530,1014,2777
64,0,63,0,685,613,1361
0,64,41,0,750,625,1416
-48,-16,390,0,1410,1117,2917
64,16,38,0,736,534,1308
32,-16,352,0,1608,1056,3016
-32,-16,391,0,1531,1113,3035
-64,16,33,0,653,573,1259
48,32,214,0,1597,1352,3163
48,0,352,0,1672,1264,3288
32,16,259,0,1660,1371,3290
-16,-64,17,0,867,796,1680
32,32,122,31,1693,1590,3436
-16,-32,222,0,1793,1459,3474
-16,64,41,0,975,732,1748
16,-64,34,0,1039,793,1866
0,48,171,0,1892,1553,3616
0,-64,21,2,1063,942,2028
-32,-48,214,0,1793,1627,3634
16,48,436,0,1765,1465,3666
0,0,371,0,1701,1608,3680
-16,-16,292,0,1714,1758,3764
64,-16,46,0,1210,742,1998
16,64,74,0,1099,847,2020
32,48,230,0,2022,1640,3892
64,-32,43,0,1005,747,1795
64,32,14,0,771,605,1390
-32,48,230,0,2317,1594,4141
-48,48,44,0,1044,950,2038
32,0,370,0,2194,1624,4188
-16,32,215,0,2223,1758,4196
-48,-48,43,0,1200,969,2212
48,-48,63,0,1007,1023,2093
48,48,42,0,896,1229,2167
48,64,20,0,782,692,1494
-64,-16,76,0,1315,1042,2433
64,-48,58,0,875,564,1497
32,-64,44,3,1021,949,2017
-64,32,30,0,1178,1062,2270
48,-64,40,0,725,877,1642
-16,0,208,14,2359,2151,4732
192,144,22,0,772,632,1426
-64,64,84,0,944,682,1710
-16,16,322,0,2604,1969,4895
-32,-64,37,0,1355,1144,2536
160,144,39,0,748,620,1407
-48,-64,65,0,1141,1025,2231
64,48,49,0,1063,948,2060
-64,-48,45,0,1104,1015,2164
-64,-64,39,0,907,1142,2088
192,176,27,0,632,569,1228
32,64,50,0,1477,1041,2568
192,160,47,0,898,794,1739
208,176,110,0,457,415,982
-32,64,71,0,1498,1146,2715
-64,-32,52,0,1571,1113,2736
208,128,16,0,763,547,1326
-64,48,47,0,1276,1375,2698
-48,64,52,0,1579,1101,2732
160,160,76,0,988,868,1932
160,112,22,0,953,823,1798
176,96,76,0,682,592,1350
176,112,66,0,1149,818,2033
128,160,45,0,685,595,1325
224,160,14,0,716,568,1298
176,192,38,0,997,768,1803
160,176,123,0,1058,788,1969
160,192,40,0,686,672,1398
144,176,48,0,1002,844,1894
144,112,83,0,1076,763,1922
128,144,49,0,967,806,1822
208,112,48,0,1169,952,2169
128,128,39,0,734,732,1505
224,176,14,0,682,723,1419
144,144,47,0,1703,1265,3015
128,176,34,0,715,702,1451
208,96,43,0,833,691,1567
176,160,51,0,1833,1532,3416
176,144,102,1,1998,1463,3564
224,144,53,0,1161,1088,2302
64,64,57,0,2225,1416,3698
208,192,15,0,917,861,1793
224,128,54,0,1164,903,2121
176,208,35,0,853,730,1618
176,128,57,0,1886,1669,3612
144,96,39,0,1007,960,2006
144,192,46,0,1073,911,2030
160,128,50,0,1968,1403,3421
192,128,98,0,1944,1550,3592
128,112,28,0,989,912,1929
160,80,39,0,720,839,1598
192,96,44,0,1225,976,2245
176,80,19,0,904,844,1767
240,128,76,0,652,632,1360
192,80,62,0,716,783,1561
64,-64,49,0,2435,1641,4125
208,160,71,0,1607,1400,3078
240,144,39,0,996,828,1863
240,160,51,0,785,930,1766
224,112,78,0,1135,1004,2217
192,192,55,0,1287,1310,2652
112,144,38,0,1017,937,1992
128,96,80,0,585,558,1223
112,160,43,0,664,654,1361
176,176,76,0,1903,1807,3786
208,144,145,0,2134,1548,3827
112,176,31,0,769,354,1154
144,128,119,0,2058,1287,3464
144,160,146,0,1930,1364,3440
160,208,45,0,1089,790,1924
144,208,60,0,648,277,985
160,96,84,0,1730,1077,2891
192,208,49,0,941,668,1658
192,112,111,0,2439,1309,3859
208,208,54,0,688,293,1035
128,192,49,0,980,576,1605
240,112,50,0,860,512,1422
240,96,14,0,506,250,770
224,192,60,0,1040,556,1656
112,128,43,0,1077,617,1737
224,96,51,0,952,624,1627
144,80,60,0,866,307,1233
112,192,98,0,653,342,1093
128,80,16,0,728,269,1013
112,96,105,0,691,219,1015
240,80,23,0,555,274,852
224,208,38,0,777,239,1054
112,112,114,0,870,310,1294
224,80,77,0,678,259,1014
128,208,53,1,901,221,1176
112,80,31,3,673,254,961
240,176,111,0,956,229,1296
208,80,77,0,1105,210,1392
112,208,48,0,669,224,941
240,192,42,0,676,264,982
240,208,45,0,614,255,914
48,0,219,0,504,346,1069
16,32,170,0,554,353,1077
0,16,241,0,503,394,1138
-32,-32,177,0,635,480,1292
16,-32,145,21,653,516,1335
32,32,177,0,694,564,1435
-16,-32,242,0,666,544,1452
32,0,210,0,836,650,1696
16,0,299,0,749,652,1700
-48,16,167,0,850,685,1702
16,48,154,23,891,683,1751
0,-16,198,0,759,859,1816
-16,16,241,0,881,732,1854
0,32,246,0,831,787,1864
-16,0,255,0,791,854,1900
32,-32,282,0,869,791,1942
-48,0,168,0,988,786,1942
16,-48,10,0,462,323,795
-16,-48,168,0,1073,806,2047
0,-32,145,21,876,1039,2081
-32,16,282,0,971,833,2086
48,-16,57,0,607,454,1118
-32,-16,254,0,1042,925,2221
48,16,158,0,1096,999,2253
-48,-16,59,0,706,471,1236
-32,48,39,0,612,432,1083
32,-16,318,0,1153,940,2411
0,-48,242,0,1195,1031,2468
32,16,178,0,1443,993,2614
16,16,254,0,1243,1221,2718
32,-48,13,0,663,579,1255
-32,32,168,0,1656,997,2821
48,-32,35,0,810,582,1427
-32,-48,66,0,857,604,1527
16,-64,46,0,482,354,882
48,32,28,0,631,490,1149
-16,-16,169,11,1431,1302,2913
0,48,254,0,1459,1287,3000
0,64,28,0,681,521,1230
-16,32,242,0,1712,1201,3155
32,48,14,0,745,698,1457
16,64,37,0,542,433,1012
0,0,300,0,1634,1346,3280
-48,32,14,0,902,654,1570
-16,48,240,0,1575,1522,3337
48,48,40,0,441,529,1010
0,-64,36,0,713,734,1483
64,16,63,0,819,563,1445
-48,48,33,0,563,444,1040
16,-16,289,0,1850,1317,3456
64,0,32,0,907,705,1644
-64,16,45,0,774,662,1481
-64,0,42,0,957,783,1782
-32,0,300,0,1877,1546,3723
64,32,45,0,490,314,849
-48,-32,83,0,1148,774,2005
-16,-64,69,0,999,916,1984
-16,64,87,0,1201,792,2080
-64,-16,41,0,1077,794,1912
48,-64,50,0,450,494,994
32,-64,43,0,806,627,1476
48,-48,42,0,1007,762,1811
192,144,59,0,485,344,888
64,-64,33,0,650,402,1085
48,64,20,0,826,496,1342
-64,-32,89,0,944,609,1642
32,64,61,0,975,618,1654
-64,48,69,0,769,790,1628
64,64,38,0,779,469,1286
-64,-48,37,0,824,631,1492
160,160,28,0,525,400,953
-64,-64,12,0,623,900,1535
176,144,31,0,786,714,1531
192,160,74,0,646,634,1354
192,176,29,0,373,309,711
160,144,26,0,741,735,1502
64,-16,73,0,1806,1153,3032
176,128,34,0,833,766,1633
176,112,15,0,534,412,961
160,128,75,0,785,642,1502
-64,32,38,0,1506,1204,2748
208,128,14,0,517,390,921
-48,-48,68,0,1671,1376,3115
160,112,29,0,628,607,1264
144,144,11,0,720,732,1463
144,176,34,0,458,416,908
208,144,37,0,922,713,1672
-32,-64,51,0,1684,1213,2948
-48,-64,108,0,1427,1162,2697
64,48,135,0,1244,1056,2435
208,160,12,0,554,605,1171
144,128,65,0,645,564,1274
176,176,27,0,713,916,1656
64,-32,71,0,1966,1271,3308
144,160,36,0,605,628,1269
160,176,35,0,720,683,1438
128,144,14,0,529,389,932
144,112,54,0,692,577,1323
-48,64,49,0,1813,1230,3092
208,176,12,0,588,577,1177
224,160,33,0,467,394,894
176,160,44,0,1345,1242,2631
192,112,63,0,967,903,1933
208,112,39,0,768,694,1501
-32,64,48,0,1924,1385,3357
224,128,40,0,541,312,893
-64,64,70,0,1620,1255,2945
192,192,18,0,606,650,1274
64,-48,103,0,1763,1445,3311
176,192,44,0,898,646,1588
144,96,37,0,508,361,906
192,128,40,0,1390,1387,2817
176,96,39,0,869,736,1644
240,160,23,1,426,368,818
224,144,59,0,954,675,1688
240,128,11,0,410,330,751
128,112,51,0,606,497,1154
240,144,13,0,613,487,1113
192,96,76,0,807,570,1453
160,192,79,0,888,736,1703
176,80,19,0,549,469,1037
128,176,70,0,666,589,1325
144,192,15,0,824,613,1452
224,192,33,0,439,362,834
160,80,38,0,583,512,1133
112,144,42,0,828,657,1527
224,112,34,0,955,732,1721
144,80,16,0,498,314,828
112,128,33,0,674,575,1282
192,208,37,0,688,591,1316
160,208,39,0,804,736,1579
240,176,38,0,437,357,832
208,208,13,0,523,376,912
128,160,41,0,1561,1027,2629
112,176,36,0,710,578,1324
112,192,32,0,481,413,926
112,96,19,0,482,352,853
160,96,47,0,1489,1016,2552
208,192,25,0,1214,968,2207
128,208,20,0,589,386,995
224,96,30,0,811,663,1504
144,208,40,0,758,540,1338
128,80,26,0,618,355,999
240,96,61,0,527,386,974
128,128,56,0,1530,1028,2614
224,176,104,0,1267,896,2267
240,192,38,0,473,384,895
112,112,46,0,567,594,1207
112,80,39,0,512,345,896
128,96,58,0,1129,671,1858
208,96,48,0,1722,679,2449
128,192,20,0,1237,568,1825
112,160,98,0,1257,657,2012
224,80,29,0,740,286,1055
240,112,47,0,1187,436,1670
192,80,44,0,1401,661,2106
224,208,66,0,788,316,1170
176,208,71,0,1694,582,2347
112,208,39,0,550,243,832
240,80,19,0,535,233,787
208,80,91,0,1324,168,1583
240,208,35,0,441,298,774
256,128,12,0,151,79,242
256,96,26,0,182,130,338
256,112,27,0,185,155,367
256,176,26,0,181,166,373
256,80,28,0,219,164,411
256,144,27,0,196,190,413
256,192,26,0,210,179,415
256,160,28,0,215,173,416
256,208,28,0,240,149,417
128,224,61,0,160,153,374
240,224,56,5,157,157,375
192,224,32,0,227,145,404
176,224,33,0,227,169,429
224,224,32,0,229,170,431
144,224,61,0,208,163,432
160,224,33,0,236,163,432
208,224,33,0,238,162,433
256,224,61,0,229,155,445
112,224,6,0,25,19,50
16,-48,171,0,632,374,1177
16,-32,232,0,543,430,1205
16,48,232,0,628,457,1317
0,-32,118,0,769,519,1406
-16,32,257,0,691,557,1505
-32,48,223,0,775,579,1577
32,16,160,0,882,541,1583
32,32,119,4,850,651,1624
-48,16,183,0,826,642,1651
0,32,300,0,736,652,1688
16,16,215,0,823,654,1692
-32,32,243,0,836,614,1693
-48,0,298,0,835,586,1719
0,-16,335,0,735,685,1755
16,32,316,0,812,635,1763
-16,16,257,42,835,631,1765
0,0,317,0,868,799,1984
-16,48,257,0,919,846,2022
-48,-16,334,0,1044,765,2143
32,-16,335,0,1075,769,2179
-32,-16,378,0,1114,692,2184
-32,0,317,0,1175,721,2213
-32,-32,396,0,1089,805,2290
32,-48,25,0,599,444,1068
48,-32,61,0,722,471,1254
-32,-48,33,0,773,523,1329
48,32,31,0,522,459,1012
48,16,183,0,1407,971,2561
-48,32,16,0,581,471,1068
32,48,75,0,798,744,1617
64,-16,48,0,678,536,1262
64,0,37,0,724,645,1406
0,-48,315,0,1622,1175,3112
64,16,41,0,766,584,1391
-64,0,68,0,766,674,1508
0,64,39,0,841,652,1532
16,-64,60,0,788,663,1511
48,0,376,0,1688,1272,3336
-64,16,35,0,673,646,1354
-16,-64,79,0,915,784,1778
0,-64,33,0,925,859,1817
-48,-32,85,0,1061,827,1973
-16,-32,224,0,2019,1335,3578
-64,32,63,0,535,557,1155
-16,64,68,0,994,853,1915
0,16,316,0,1858,1541,3715
16,64,33,0,865,808,1706
32,-64,27,0,563,600,1190
32,-32,420,0,1925,1426,3771
64,-32,45,0,696,639,1380
0,48,171,0,2003,1602,3776
-32,-64,13,0,660,582,1255
32,0,321,0,2032,1477,3830
-16,-48,171,0,1994,1666,3831
-48,-48,38,0,833,863,1734
-16,-16,300,0,1978,1662,3940
-48,48,36,0,861,860,1757
48,48,35,0,684,1059,1778
32,64,15,0,722,601,1338
16,0,316,0,2108,1610,4034
48,-48,65,0,824,851,1740
16,-16,443,0,2009,1631,4083
-64,-16,41,0,993,928,1962
-32,16,442,0,1983,1810,4235
64,32,27,12,618,511,1168
48,-16,300,0,2117,1908,4325
-16,0,490,0,2127,1828,4445
-48,-64,14,0,839,635,1488
176,144,15,0,642,503,1160
64,48,42,0,845,597,1484
160,144,27,0,623,447,1097
48,64,37,0,970,613,1620
-64,48,16,0,933,870,1819
-64,-48,49,0,960,658,1667
-64,-32,45,0,1131,761,1937
160,128,68,0,634,472,1174
-64,-64,12,0,708,767,1487
192,128,14,0,650,519,1183
192,176,48,0,500,435,983
64,-48,29,0,1111,739,1879
192,144,16,0,801,629,1446
144,144,38,0,623,611,1272
-64,64,39,0,1002,685,1726
176,128,78,0,861,688,1627
64,-64,46,0,1045,747,1838
160,112,64,0,702,752,1518
208,112,33,0,716,496,1245
144,128,53,0,816,602,1471
144,160,89,0,784,573,1446
192,112,71,0,988,704,1763
208,176,43,0,556,516,1115
176,192,14,0,617,457,1088
128,144,57,0,571,428,1056
224,128,15,0,618,441,1074
160,192,58,0,554,524,1136
192,192,13,0,569,603,1185
-32,64,45,0,2175,1520,3740
128,128,32,0,645,560,1237
176,96,15,0,779,721,1515
160,96,55,0,695,593,1343
128,160,13,0,787,630,1430
224,144,48,0,788,680,1516
192,160,56,1,1381,1185,2623
224,160,36,0,755,736,1527
144,192,38,0,677,654,1369
-48,64,46,0,2020,1361,3427
64,64,50,0,1885,1131,3066
128,176,13,0,557,567,1137
144,96,62,0,739,660,1461
208,192,63,0,612,645,1320
224,176,34,0,609,664,1307
224,112,39,0,772,744,1555
176,160,90,0,1790,1208,3088
176,80,43,0,472,478,993
192,96,20,0,937,796,1753
128,112,39,0,665,704,1408
240,160,14,0,585,493,1092
208,160,42,0,1437,1341,2820
48,-64,74,0,1793,1850,3717
160,160,105,0,1761,1370,3236
112,144,37,0,719,738,1494
208,96,40,0,914,740,1694
160,80,13,0,511,500,1024
240,144,15,0,767,582,1364
176,112,91,0,1769,1370,3230
176,176,80,0,1643,1719,3442
208,128,71,0,1905,1288,3264
208,144,82,0,2092,1341,3515
112,160,41,0,538,467,1046
192,80,45,0,649,560,1254
144,176,44,0,1526,1455,3025
160,176,117,0,1897,1381,3395
176,208,43,0,904,796,1743
144,112,100,0,1949,1261,3310
128,96,36,0,669,549,1254
192,208,14,0,779,589,1382
128,208,14,0,553,338,905
240,112,43,0,725,476,1244
208,80,41,0,705,351,1097
224,192,15,0,852,506,1373
112,128,41,0,860,514,1415
160,208,43,0,951,673,1667
240,96,39,0,444,359,842
224,96,29,0,812,563,1404
112,112,14,0,604,497,1115
144,208,25,0,779,429,1233
240,80,16,0,459,346,821
128,80,17,0,733,330,1080
240,176,36,0,740,393,1169
208,208,83,0,824,396,1303
240,128,20,0,1263,462,1745
112,80,16,0,627,307,950
112,208,39,0,580,303,922
224,208,68,0,740,302,1110
128,192,60,0,1157,409,1626
112,192,22,0,975,257,1254
112,96,16,0,836,209,1061
112,176,51,0,1112,338,1501
144,80,54,0,1153,255,1462
240,208,75,0,619,279,973
224,80,51,0,898,111,1060
240,192,66,0,875,103,1044
96,160,25,0,184,163,372
96,176,24,0,174,177,375
96,112,25,0,202,155,382
96,192,58,0,154,180,392
96,144,24,0,180,190,394
96,80,47,0,183,164,394
96,96,25,0,196,175,396
96,128,26,0,203,169,398
96,208,25,0,216,157,398
112,64,50,0,173,145,368
128,64,62,0,209,140,411
144,64,62,0,206,144,412
240,64,62,0,214,157,433
224,64,63,0,217,156,436
160,64,63,0,210,163,436
176,64,63,0,222,153,438
208,64,64,0,244,131,439
192,64,66,0,246,128,440
256,128,36,0,151,106,293
256,96,38,0,164,135,337
256,112,38,0,166,162,366
256,176,38,0,171,192,401
256,144,41,0,192,169,402
256,80,50,0,221,134,405
256,192,38,0,198,170,406
256,160,50,0,215,142,407
256,64,53,0,271,84,408
256,208,8,0,55,19,82
128,224,35,0,174,142,351
240,224,27,0,183,163,373
192,224,36,0,195,150,381
144,224,36,0,202,170,408
160,224,36,0,201,172,409
176,224,45,0,188,177,410
256,224,69,0,197,145,411
208,224,69,0,199,143,411
224,224,37,0,204,171,412
272,128,21,0,169,130,320
272,112,35,0,181,134,350
272,192,35,0,179,146,360
272,208,33,0,184,145,362
272,176,20,0,175,167,362
272,144,34,0,193,156,383
272,96,33,0,201,149,383
272,80,36,0,229,120,385
272,160,35,0,227,125,387
272,224,10,0,51,7,68
288,112,36,0,180,144,360
288,128,36,0,181,150,367
288,208,38,0,209,148,395
288,192,39,0,189,172,400
288,96,36,0,209,155,400
288,144,37,0,211,154,402
288,80,37,0,226,155,418
288,176,37,0,187,195,419
288,160,36,0,222,162,420
304,192,21,0,174,134,329
304,176,37,0,179,160,376
304,112,37,0,210,136,383
304,208,36,0,184,165,385
304,144,52,0,172,163,387
304,160,37,0,203,149,389
304,128,36,0,204,149,389
304,80,39,0,241,124,404
304,96,38,0,242,124,404
0,-32,37,0,190,129,356
0,32,54,0,230,184,468
16,-32,62,0,287,292,641
0,0,109,0,267,284,660
0,-16,43,0,308,328,679
16,16,41,0,319,326,686
16,32,40,0,370,317,727
-16,-32,62,0,339,330,731
0,16,78,0,333,359,770
32,0,76,0,375,319,770
16,0,68,0,383,320,771
16,-16,105,0,379,292,776
-16,-16,58,4,387,385,834
-32,0,87,0,452,323,862
-32,-16,95,0,478,305,878
-16,16,116,0,459,346,921
32,-16,83,0,527,348,958
-16,32,18,0,372,217,607
-16,0,107,0,472,398,977
-32,16,31,0,376,176,583
32,16,37,0,343,243,623
32,-32,38,0,334,233,605
-48,16,21,0,258,212,491
48,0,22,0,273,250,545
48,16,18,0,222,232,472
0,-48,17,0,289,288,594
-48,0,28,0,314,276,618
32,32,42,0,295,332,669
-32,32,23,0,354,335,712
0,48,45,0,298,359,702
16,48,21,0,313,302,636
-32,-32,28,0,423,375,826
16,-48,27,0,284,284,595
-16,48,20,0,370,308,698
-16,-48,19,0,380,305,704
-48,-16,33,0,406,277,716
-32,48,22,0,401,239,662
48,-16,24,0,460,319,803
32,-48,18,0,281,206,505
48,32,17,0,266,233,516
48,-32,44,0,358,219,621
32,48,22,0,346,274,642
-48,32,35,0,312,285,632
64,0,36,0,326,267,629
-32,-48,25,0,448,339,812
0,64,24,0,364,295,683
64,16,22,0,339,240,601
-64,0,30,0,374,328,732
16,-64,26,0,306,252,584
-48,-32,25,0,451,303,779
-64,16,19,0,274,207,500
0,-64,25,0,393,360,778
64,-16,18,0,365,245,628
-16,-64,21,0,416,356,793
-16,64,33,0,448,333,814
16,64,16,0,380,296,692
-64,-16,26,0,410,241,677
48,48,21,0,283,274,578
-48,-48,23,0,384,255,662
-48,48,25,0,393,256,674
64,32,12,0,299,198,509
48,-48,29,0,390,320,739
-64,32,41,0,347,320,708
32,-64,33,0,367,350,750
-32,-64,25,0,408,343,776
32,64,22,0,407,311,740
64,-32,50,0,439,356,845
-64,-32,30,0,433,302,765
-48,64,22,0,339,278,639
-32,64,34,0,427,358,819
-64,48,39,0,342,417,798
-48,-64,30,0,357,304,691
-64,-48,27,0,285,270,582
64,48,21,0,273,238,532
48,64,13,0,372,290,675
48,-64,20,0,283,343,646
-64,-64,25,0,245,282,552
64,-48,32,0,457,295,784
-64,64,18,0,361,201,580
64,64,26,0,377,287,690
240,160,14,0,309,249,572
240,144,26,0,345,282,653
64,-64,20,0,439,307,766
240,128,26,0,311,270,607
256,128,36,0,280,265,581
224,144,32,0,301,286,619
256,160,33,0,323,285,641
272,144,33,0,274,272,579
240,112,19,0,249,246,514
256,144,17,0,382,364,763
240,176,35,0,293,286,614
224,160,41,0,321,309,671
224,128,32,0,356,273,661
208,144,22,0,375,287,684
224,112,19,0,348,252,619
256,112,13,0,320,276,609
256,176,13,0,292,257,562
208,176,33,0,181,156,370
208,128,19,0,351,234,604
208,160,31,0,268,274,573
224,176,39,0,269,281,589
272,128,13,0,337,300,650
272,112,20,0,301,260,581
272,176,23,0,264,276,563
192,144,20,0,292,240,552
208,112,26,0,388,289,703
240,96,12,0,337,293,642
272,160,24,0,415,323,762
240,192,24,0,339,291,654
192,160,24,0,290,290,604
288,144,36,0,398,310,744
224,96,17,0,336,273,626
224,192,16,0,371,256,643
256,192,21,0,400,305,726
288,128,22,0,315,218,555
288,160,37,0,402,300,739
256,96,28,0,285,230,543
208,192,27,0,288,246,561
192,128,28,0,296,276,600
288,112,23,0,320,243,586
272,96,18,0,277,232,527
272,192,23,0,311,229,563
176,144,18,0,272,224,514
192,176,32,0,282,252,566
208,96,23,0,461,297,781
288,176,23,0,340,305,668
240,80,12,0,272,226,510
192,112,38,0,405,299,742
256,80,29,0,297,222,548
304,144,22,0,377,267,666
240,208,21,0,381,413,815
224,208,21,0,354,258,633
304,160,20,0,411,287,718
224,80,36,0,381,286,703
192,192,19,0,182,213,414
176,160,13,0,306,283,602
304,128,38,0,351,277,666
256,208,15,0,341,260,616
192,96,22,0,341,247,610
176,128,13,0,346,289,648
288,192,14,0,327,258,599
176,176,18,0,273,254,545
304,112,35,0,363,240,638
288,96,25,0,359,295,679
208,80,15,0,356,197,568
208,208,16,0,304,217,537
272,208,22,0,327,254,603
192,80,22,0,270,219,511
304,176,34,0,309,236,579
272,80,41,0,406,270,717
176,112,25,0,354,259,638
192,208,23,0,306,233,562
176,192,18,0,332,239,589
176,96,28,0,297,179,504
176,80,21,0,268,148,437
288,80,24,0,313,159,496
288,208,22,0,381,164,567
304,96,36,0,379,130,545
304,192,25,0,323,127,475
176,208,21,0,313,59,393
304,208,19,0,275,33,327
304,80,24,0,288,27,339
320,144,26,0,121,113,260
320,176,22,0,119,116,257
320,160,26,0,120,116,262
320,128,27,0,126,116,269
320,112,23,0,145,113,281
320,192,22,0,142,120,284
320,80,22,0,155,102,279
320,96,30,0,167,95,292
320,208,22,0,155,119,296
224,64,26,0,129,95,250
240,64,30,0,128,98,256
208,64,27,0,142,125,294
256,64,36,0,154,113,303
192,64,42,0,132,131,305
304,64,43,0,158,107,308
288,64,47,0,153,112,312
320,64,42,0,168,97,307
272,64,46,0,172,95,313
288,48,16,0,108,116,240
304,48,16,0,127,119,262
272,48,15,0,128,120,263
320,48,16,0,128,122,266
224,48,18,0,125,126,269
240,48,16,0,137,119,272
256,48,16,0,136,120,272
208,48,17,0,150,109,276
192,48,19,0,159,106,284
176,64,14,0,48,10,72
176,48,16,0,64,8,88
288,32,19,0,106,86,211
304,32,21,0,102,111,234
208,32,21,0,140,108,269
192,32,21,0,137,121,279
256,32,20,0,123,136,279
224,32,36,0,144,108,288
272,32,22,0,123,144,289
240,32,30,0,164,96,290
176,32,26,0,142,122,290
160,144,12,0,103,68,183
160,96,20,0,126,116,262
160,80,24,0,118,125,267
160,112,18,0,118,130,266
160,160,17,0,116,134,267
160,128,18,0,124,125,267
160,64,19,0,132,117,268
160,32,27,0,162,92,281
160,48,23,0,170,90,283
288,16,22,0,96,93,211
304,16,28,0,109,79,216
240,16,27,0,123,113,263
256,16,27,0,133,117,277
176,16,28,0,137,115,280
272,16,27,0,145,108,280
224,16,30,0,157,99,286
192,16,33,0,154,97,284
208,16,28,0,160,99,287
192,16,9,0,77,18,104
208,16,11,0,77,20,108
160,16,7,0,42,7,56
288,0,15,0,95,107,217
240,0,16,0,105,116,237
256,0,17,0,121,116,254
176,0,31,0,116,109,256
160,0,16,0,126,117,259
272,0,21,0,119,119,259
224,0,33,0,150,99,282
192,0,33,0,152,97,282
208,0,33,0,162,89,284
304,0,5,0,35,7,47
0,-32,51,3,304,259,617
-16,-32,52,8,291,290,641
0,32,82,0,291,370,743
-16,0,128,0,266,359,753
16,32,75,0,313,469,857
-16,16,55,10,335,497,897
16,16,83,0,357,514,954
-32,0,107,0,335,524,966
16,-16,102,0,376,499,977
0,16,58,0,420,511,989
16,-32,81,0,437,569,1087
16,0,127,0,457,525,1109
0,0,112,0,385,640,1137
-32,-16,104,0,576,484,1164
-16,-16,87,0,508,576,1171
32,-32,65,0,466,269,800
0,-16,93,0,523,647,1263
32,16,62,0,447,298,807
32,0,133,0,655,520,1308
32,-16,101,0,673,536,1310
-48,16,42,0,456,321,819
48,0,28,0,484,359,871
48,16,40,1,439,324,804
-32,32,57,0,699,460,1216
-16,32,38,0,719,516,1273
0,-48,55,0,663,548,1266
-32,16,61,0,719,524,1304
-32,-32,58,0,681,546,1285
0,48,60,0,667,617,1344
32,32,43,0,710,602,1355
-48,0,88,0,775,500,1363
16,48,32,0,724,503,1259
-16,-48,53,0,631,415,1099
-48,32,49,0,394,317,760
-16,48,31,0,668,547,1246
-64,0,43,0,451,344,838
0,-64,12,0,379,310,701
16,-48,29,0,713,462,1204
-32,-48,28,0,659,459,1146
-32,48,40,0,705,497,1242
64,16,49,0,437,277,763
32,-48,31,0,615,496,1142
-16,-64,16,0,373,324,713
48,-16,31,0,751,562,1344
-48,-16,38,0,812,504,1354
32,48,66,0,697,517,1280
48,32,49,0,709,513,1271
48,-32,31,0,790,559,1380
0,64,45,0,686,473,1204
-48,-32,58,0,704,506,1268
64,0,39,0,731,502,1272
16,64,28,1,558,382,969
16,-64,30,0,569,461,1060
64,-32,43,0,414,289,746
-32,-64,28,0,360,299,687
32,-64,27,0,360,322,709
-16,64,32,0,668,452,1152
-48,64,11,0,361,284,656
-64,16,53,0,662,492,1207
64,32,25,0,394,294,713
64,-16,29,0,707,510,1246
48,48,31,0,532,622,1185
-48,-48,27,0,620,581,1228
48,-48,25,0,567,478,1070
-64,-16,30,0,670,590,1290
-48,48,32,0,581,525,1138
-64,32,19,0,556,457,1032
-32,64,45,0,547,443,1035
32,64,29,0,526,437,992
-64,48,41,0,449,615,1105
-64,-32,38,0,624,481,1143
48,64,26,0,584,503,1113
-96,32,17,0,376,315,708
-48,-64,42,0,619,514,1175
-80,32,14,6,391,270,681
-96,48,29,0,356,282,667
64,-48,25,0,612,514,1151
-64,-48,38,0,599,516,1153
64,48,33,0,648,457,1138
-112,32,28,0,379,328,735
-64,64,25,0,608,481,1114
-80,16,42,0,396,302,740
48,-64,29,0,548,722,1299
64,64,26,0,567,458,1051
64,-64,28,0,586,456,1070
-64,-64,19,1,548,708,1276
-96,64,23,0,546,398,967
-96,16,35,0,703,483,1221
-80,48,40,0,663,469,1172
-64,32,28,0,629,494,1151
-112,48,31,0,604,575,1210
-128,48,25,0,421,314,760
-128,0,15,0,413,327,755
-64,0,25,0,449,354,828
-112,16,32,0,700,570,1302
-80,64,23,0,661,429,1113
-112,0,25,0,658,507,1190
-96,0,30,0,680,498,1208
-128,32,45,0,654,572,1271
-96,-16,14,0,404,316,734
-80,0,31,0,666,504,1201
-48,32,34,0,384,319,737
-64,16,19,0,634,446,1099
-112,64,49,0,617,460,1126
-128,16,29,0,727,481,1237
-64,64,30,0,631,421,1082
-64,48,31,0,583,611,1225
-96,80,15,0,580,543,1138
-128,64,41,0,638,567,1246
-80,80,26,0,572,441,1039
-48,48,29,0,611,436,1076
-112,80,29,0,588,458,1075
-144,32,21,0,670,502,1193
-144,48,29,0,642,482,1153
-128,-16,21,0,363,325,709
-48,0,56,0,382,282,720
-96,96,38,0,280,286,604
-64,-16,31,0,402,294,727
-112,-16,38,0,585,423,1046
-96,-32,30,0,379,271,680
-144,16,18,0,608,460,1086
-48,16,58,0,628,467,1153
-128,80,17,0,576,493,1086
-48,64,33,0,535,402,970
-144,64,34,0,560,372,966
-80,-16,36,0,620,499,1155
-64,80,24,0,561,442,1027
-32,32,31,0,537,419,987
-32,48,26,0,524,399,949
-144,0,44,0,624,443,1111
-160,32,43,0,642,450,1135
-160,64,44,0,358,268,670
-32,0,37,0,416,290,743
-128,-32,36,0,388,337,761
-112,-32,49,0,572,617,1238
-64,-32,31,0,367,342,740
-80,-32,29,0,641,530,1200
-64,96,13,0,317,352,682
-112,96,22,0,579,565,1166
-32,16,49,0,542,570,1161
-160,48,34,0,608,473,1115
-80,96,17,0,593,447,1057
-144,-16,45,0,519,480,1044
-160,16,30,0,554,488,1072
-144,80,37,0,628,349,1014
-48,80,43,0,504,484,1031
-128,96,28,0,546,349,923
-48,-16,32,0,658,434,1124
-48,96,14,0,549,170,733
-160,0,28,0,611,300,939
-32,64,17,0,618,286,921
-144,96,14,0,590,243,847
-160,80,27,0,594,242,863
-144,-32,44,0,583,199,826
-160,-32,18,0,460,167,645
-160,96,37,0,297,181,515
-48,-32,33,0,553,174,760
-32,-32,14,0,304,185,503
-32,96,12,0,225,188,425
-160,-16,30,0,562,201,793
-32,-16,28,0,617,175,820
-32,80,49,0,497,169,715
16,32,63,0,275,244,582
0,0,52,0,302,275,629
-16,-16,64,0,305,292,661
16,0,79,0,342,300,721
0,48,17,0,248,338,603
32,16,32,0,308,349,689
16,48,19,0,270,258,547
-32,0,91,0,393,324,808
-48,16,26,0,307,265,598
-32,-16,91,0,411,325,827
-48,0,34,0,308,271,613
-16,0,80,0,370,380,830
-16,-32,63,0,475,398,936
32,0,73,0,468,429,970
-32,-32,45,0,512,459,1016
-48,32,22,0,276,213,511
0,64,26,0,303,202,531
-64,0,33,0,310,217,560
32,-48,41,0,448,332,821
-32,-64,32,0,337,219,588
-48,48,33,0,368,270,671
32,-64,34,0,324,233,591
-64,48,28,0,282,265,575
64,64,20,0,313,219,552
240,96,20,0,278,225,523
256,80,20,0,313,226,559
256,96,20,0,260,243,523
240,64,29,0,313,228,570
64,48,29,0,384,294,707
-32,64,35,0,564,379,978
272,80,33,0,386,237,656
240,80,27,0,401,360,788
48,-64,23,0,414,493,930
240,48,22,0,348,238,608
256,64,37,0,456,329,822
272,48,29,0,353,232,614
272,112,24,0,275,206,505
256,128,16,0,238,186,440
208,80,29,0,517,389,935
208,112,25,0,380,302,707
224,128,15,0,301,217,533
272,96,29,0,368,411,808
192,80,28,0,305,289,622
240,32,37,0,380,233,650
208,128,21,0,346,189,556
192,64,21,0,370,239,630
176,80,18,0,286,157,461
208,32,24,0,467,309,800
256,16,19,0,320,244,583
304,96,29,0,365,244,638
272,128,18,0,439,354,811
288,32,29,0,244,216,489
176,96,20,0,291,276,587
288,128,28,0,273,227,528
288,64,37,0,547,430,1014
304,64,23,0,353,254,630
192,32,29,0,293,276,598
304,48,30,0,303,244,577
192,48,23,0,522,371,916
304,80,21,0,527,322,870
304,112,22,0,316,173,511
192,144,17,0,289,163,469
272,144,30,0,321,201,552
208,144,30,0,362,172,564
192,16,18,0,328,141,487
176,128,24,0,408,83,515
304,16,24,0,184,14,222
176,144,19,4,197,17,237
192,160,19,0,148,19,186
176,160,30,0,123,16,169
272,160,33,0,197,14,244
304,160,29,0,118,19,166
160,32,43,0,374,100,517
160,32,30,0,171,9,210
224,0,87,0,195,10,292
192,0,43,0,231,10,284
240,-16,90,0,244,85,419
256,-16,36,0,268,40,344
288,-16,31,0,192,39,262
224,-16,57,0,312,30,399
304,-16,27,0,189,29,245
288,-32,33,0,154,11,198
192,-48,17,0,233,146,396
256,-48,40,0,366,222,628
224,-48,55,0,454,127,636
208,-48,46,0,466,89,601
320,32,32,0,208,14,254
320,-48,18,0,136,31,185
320,-32,23,0,153,20,196
320,80,31,0,137,19,187
0,-32,35,0,183,184,402
0,-16,64,0,159,201,424
0,32,41,0,208,212,461
16,16,42,0,222,225,489
16,32,48,0,262,250,560
-16,-32,59,0,233,271,563
16,-32,36,0,242,306,584
0,0,41,0,263,315,619
16,0,47,0,320,305,672
-32,0,70,0,342,262,674
0,16,37,10,310,321,678
16,-16,48,0,380,293,721
-16,16,47,1,364,321,733
32,0,47,0,348,343,738
-16,-16,46,1,321,369,737
-16,0,66,0,401,373,840
-32,-16,72,0,452,319,843
32,-16,72,0,484,302,858
32,16,21,0,278,162,461
-32,16,37,0,313,186,536
-16,32,21,0,368,250,639
32,-32,26,0,337,194,557
-32,32,23,0,324,236,583
0,-48,19,0,269,218,506
0,48,36,0,286,258,580
32,32,22,0,315,293,630
-48,0,22,0,310,236,568
-48,16,20,0,298,211,529
16,48,21,0,288,227,536
48,16,14,0,264,254,532
-32,-32,25,0,382,322,729
48,0,23,0,340,249,612
16,-48,15,0,235,169,419
-16,48,20,0,430,307,757
-16,-48,20,0,376,297,693
-32,48,20,0,348,220,588
48,-32,23,0,341,213,577
48,-16,26,0,447,319,792
48,32,18,0,231,239,488
32,-48,21,0,281,244,546
-48,-16,28,0,479,339,846
-32,-48,22,0,371,278,671
32,48,17,0,325,256,598
-48,32,32,0,286,282,600
-64,0,21,0,305,254,580
0,64,25,0,307,232,564
64,16,28,0,314,210,552
64,0,38,0,310,283,631
0,-64,33,0,304,301,638
-16,-64,16,0,322,241,579
-48,-32,24,0,382,279,685
-64,16,21,0,264,149,434
64,-16,28,0,330,162,520
16,-64,22,0,338,229,589
16,64,26,0,355,295,676
-48,-48,23,0,330,280,633
-16,64,37,0,438,330,805
-48,48,22,0,330,274,626
-64,-16,28,0,380,303,711
-64,32,20,0,268,274,562
64,32,17,0,242,210,469
48,-48,35,0,311,278,624
48,48,22,0,291,393,706
-32,-64,24,0,322,298,644
32,-64,37,0,323,321,681
-64,-32,27,0,338,257,622
64,-32,34,0,407,319,760
32,64,19,0,353,275,647
-48,64,16,0,307,227,550
-64,48,12,0,263,302,577
-32,64,24,0,403,313,740
-48,-64,31,0,327,255,613
64,48,21,0,245,175,441
-64,-64,20,0,209,266,495
64,-48,24,0,357,242,623
48,-64,19,0,288,316,623
-64,-48,22,0,317,295,634
48,64,29,0,377,272,678
-64,64,24,0,332,254,610
64,64,22,0,321,261,604
256,16,12,0,297,266,575
64,-64,33,0,355,275,663
256,32,21,0,297,268,586
240,16,32,0,270,260,562
272,0,19,0,270,238,527
272,32,20,0,282,262,564
256,0,34,0,310,284,628
272,16,15,0,356,301,672
240,0,20,0,287,296,603
240,32,36,1,409,237,683
288,16,31,0,249,223,503
256,48,14,0,336,235,585
256,-16,37,0,273,236,546
272,48,22,0,292,222,536
240,-16,37,0,276,303,616
224,16,25,3,326,280,634
288,0,11,0,272,305,588
288,32,21,0,264,205,490
224,0,13,0,325,257,595
224,32,23,0,277,219,519
224,-16,33,0,216,219,468
288,-16,21,0,240,245,506
240,48,36,0,299,264,599
272,-16,24,0,340,331,695
288,48,16,0,295,299,610
256,-32,33,0,269,199,501
224,48,28,0,326,289,643
304,16,35,0,233,183,451
208,16,23,0,322,251,596
256,64,27,0,397,277,701
208,32,16,0,305,182,503
272,-32,20,0,234,198,452
304,0,22,0,253,204,479
272,64,20,0,339,214,573
224,-32,10,0,248,207,465
224,64,23,0,276,182,481
240,64,24,0,326,230,580
304,32,13,0,312,272,597
240,-32,25,0,293,256,574
304,-16,20,0,343,228,591
208,0,23,0,375,236,634
288,-32,16,0,342,277,635
208,-16,19,0,307,248,574
320,16,23,0,213,243,479
256,-48,13,0,200,186,399
304,48,26,0,375,278,679
192,16,14,0,309,256,579
240,80,33,0,212,195,440
240,-48,23,0,262,201,486
208,48,53,0,393,320,766
272,-48,17,0,215,245,477
288,64,38,0,430,334,802
320,32,22,0,275,249,546
320,0,18,0,267,214,499
256,80,38,0,330,299,667
208,-32,16,0,266,158,440
192,32,23,0,353,259,635
192,0,31,0,368,200,599
272,80,24,0,460,218,702
304,64,29,0,445,232,706
320,-16,47,0,267,225,539
192,-16,10,0,232,208,450
288,-48,20,0,267,226,513
224,-48,42,0,296,227,565
208,64,22,5,335,246,608
304,-32,41,0,318,274,633
224,80,24,0,278,248,550
208,-48,22,0,292,216,530
192,48,45,0,369,260,674
320,48,36,0,328,231,595
208,80,22,0,338,205,565
288,80,48,0,353,223,624
192,-32,10,0,223,146,379
192,64,23,0,324,239,586
304,80,20,0,334,165,519
320,-32,14,0,334,125,473
304,-48,17,0,343,64,424
192,-48,14,0,184,58,256
192,80,25,0,193,47,265
320,64,26,0,237,42,305
320,80,39,0,163,38,240
320,-48,15,0,182,44,241
336,0,10,0,86,93,189
336,16,10,0,98,91,199
336,-16,13,0,113,102,228
336,-48,12,0,114,102,228
336,-32,11,0,116,109,236
336,32,14,0,137,93,244
336,80,16,0,145,84,245
336,48,11,0,143,92,246
336,64,15,0,184,48,247
256,-64,12,0,100,98,210
272,-64,12,0,109,105,226
336,-64,13,0,110,111,234
320,-64,20,0,131,112,263
288,-64,16,0,114,136,266
240,-64,17,0,129,121,267
208,-64,24,0,148,99,271
304,-64,17,0,157,98,272
224,-64,19,0,145,109,273
192,-64,9,0,63,10,82
256,-80,17,0,113,96,226
272,-80,16,0,122,97,235
240,-80,17,0,115,105,237
208,-80,16,0,124,107,247
192,-80,18,0,138,109,265
224,-80,17,0,140,108,265
288,-80,18,0,149,103,270
320,-80,20,0,165,88,273
304,-80,44,0,183,49,276
240,-96,12,0,94,86,192
256,-96,16,0,105,93,214
192,-96,16,0,101,101,218
208,-96,12,0,112,104,228
272,-96,11,0,114,104,229
224,-96,11,0,124,97,232
288,-96,18,0,155,70,243
320,-96,18,0,188,47,253
304,-96,21,0,203,30,254
192,-112,12,0,98,106,216
256,-112,13,0,105,104,222
240,-112,12,0,101,115,228
208,-112,12,0,124,110,246
272,-112,13,0,121,118,252
224,-112,18,0,110,124,252
320,-112,20,0,131,101,252
304,-112,19,0,154,91,264
288,-112,17,0,130,116,263
192,-128,11,0,88,52,151
208,-128,22,0,107,103,232
272,-128,19,0,116,105,240
256,-128,20,0,120,107,247
320,-128,18,0,118,111,247
240,-128,21,0,117,109,247
288,-128,22,0,118,109,249
224,-128,18,0,122,109,249
304,-128,20,0,159,72,251
192,-144,10,0,90,80,180
208,-144,12,0,91,86,189
224,-144,13,0,107,101,221
240,-144,17,0,107,99,223
272,-144,12,0,115,98,225
256,-144,29,0,104,95,228
320,-144,20,8,138,82,248
288,-144,28,0,145,76,249
304,-144,29,0,160,62,251
224,-160,11,0,102,101,214
240,-160,11,0,107,108,226
208,-160,11,0,107,111,229
192,-160,10,0,115,106,231
256,-160,15,0,114,113,242
320,-160,17,0,140,95,252
272,-160,16,0,141,95,252
304,-160,16,0,148,88,252
288,-160,17,0,151,84,252
176,-32,10,0,93,90,193
176,-16,16,0,95,101,212
176,-128,11,0,104,114,229
176,-144,17,0,97,117,231
176,-48,17,0,117,116,250
176,-64,15,0,124,114,253
176,-112,17,0,129,108,254
176,-80,19,0,144,92,255
176,-96,18,0,149,88,255
176,-160,6,0,31,15,52
224,-176,22,0,95,89,206
208,-176,21,0,95,92,208
240,-176,22,0,102,118,242
192,-176,26,0,112,110,248
176,-176,28,0,111,114,253
272,-176,26,0,116,112,254
256,-176,22,0,120,112,254
288,-176,27,0,126,102,255
304,-176,27,0,141,94,262
160,-160,18,0,99,107,224
160,-144,18,0,103,115,236
160,-176,13,0,106,121,240
160,-48,17,0,113,109,239
160,-128,17,0,105,123,245
160,-112,18,0,143,98,259
160,-96,19,0,147,95,261
160,-80,20,0,154,88,262
160,-64,20,0,162,81,263
144,-128,11,0,104,84,199
144,-144,11,0,108,99,218
144,-96,16,0,121,107,244
144,-112,15,0,118,111,244
144,-160,17,0,117,116,250
144,-48,16,0,144,98,258
144,-80,17,0,132,109,258
144,-176,19,0,137,105,261
144,-64,19,0,176,69,264
160,-32,10,0,36,6,52
144,-32,10,0,38,6,54
160,-16,6,0,34,6,46
144,-16,11,0,33,10,54
288,0,10,0,56,23,89
160,0,11,0,68,35,114
272,0,12,0,68,35,115
176,0,13,0,68,33,114
144,0,7,0,46,6,59
128,-144,11,0,98,87,196
128,-128,10,0,106,87,203
128,-16,12,0,113,108,233
128,-96,12,0,124,102,238
128,-32,21,0,124,106,251
128,-48,18,0,138,97,253
128,-80,18,0,139,97,254
128,-112,13,0,126,115,254
128,-64,16,0,167,72,255
112,-128,11,0,69,92,172
112,-112,12,0,98,97,207
112,-144,13,0,101,100,214
112,-48,12,0,106,108,226
112,-64,15,0,116,97,228
112,-80,14,0,121,98,233
112,-32,21,0,139,75,235
112,-96,14,0,126,96,236
112,-16,15,0,129,96,240
112,-160,6,0,35,12,53
128,-160,6,0,38,11,55
96,-128,10,0,89,68,167
96,-144,10,0,90,109,209
96,-48,12,0,109,104,225
96,-112,10,0,103,118,231
96,-160,12,0,118,109,239
96,-96,12,0,118,112,242
96,-64,12,0,119,115,246
96,-80,17,0,139,92,248
96,-32,32,0,132,84,248
96,-176,12,0,76,54,142
112,-176,11,0,78,59,148
160,-176,11,0,80,57,148
128,-176,12,0,86,52,150
144,-176,12,0,95,44,151
16,32,44,0,251,249,544
32,-32,67,0,242,251,560
0,-32,37,0,201,348,586
16,16,75,0,235,283,593
-16,32,50,0,267,302,619
-16,-16,57,11,262,325,655
32,16,43,0,318,296,657
16,-32,68,0,261,335,664
-16,-32,68,0,338,310,716
-16,0,74,0,328,347,749
0,32,44,0,365,342,751
16,0,69,0,364,324,757
0,-16,75,0,353,338,766
0,0,77,0,347,346,770
0,16,75,0,467,269,811
-16,16,75,0,435,302,812
-32,16,57,0,457,299,813
-32,0,89,0,491,242,822
32,0,78,0,519,227,824
16,-16,78,0,524,223,825
32,-16,87,0,537,202,826
-32,-16,77,0,625,126,828
-32,-32,25,1,229,15,270
48,16,16,0,185,160,361
0,-48,19,0,212,201,432
-32,32,20,0,227,208,455
0,48,20,0,221,238,479
-48,0,34,0,275,206,515
48,0,30,3,314,300,647
-48,16,26,3,312,312,653
48,32,27,0,262,314,603
16,48,36,0,348,356,740
-16,-48,34,0,354,422,810
-48,-32,23,0,384,334,741
16,-48,34,0,404,400,838
48,-32,49,0,423,376,848
-32,48,31,0,431,409,871
32,32,14,0,408,479,901
-48,32,25,0,397,428,850
32,-48,26,0,381,468,875
-64,0,22,0,285,271,578
64,0,20,0,274,222,516
-48,-16,43,0,498,435,976
0,64,16,0,297,265,578
64,16,14,0,317,208,539
-16,48,36,0,503,538,1077
32,48,34,0,493,519,1046
48,-16,37,0,545,522,1104
-32,-48,28,0,562,510,1100
0,-64,22,0,350,285,657
16,-64,46,0,431,285,762
-64,16,24,0,340,252,616
16,64,20,0,357,244,621
-64,32,21,0,262,226,509
-32,-64,37,0,295,251,583
-16,-64,46,0,481,389,916
-16,64,48,0,506,372,926
64,-16,22,0,514,322,858
-48,-64,22,0,270,258,550
-32,64,22,0,348,302,672
48,48,30,0,341,441,812
32,64,36,0,336,275,647
-48,-48,39,0,426,376,841
32,-64,32,0,370,391,793
48,-48,31,0,536,459,1026
64,-32,31,0,586,411,1028
64,32,23,0,460,381,864
-48,48,24,0,555,511,1090
-64,-16,30,0,617,510,1157
64,48,20,0,246,204,470
-64,-48,35,0,311,282,628
48,-64,28,0,274,334,636
48,64,24,0,408,340,772
-48,64,22,0,577,473,1072
64,64,12,0,306,215,533
-64,-32,49,0,613,470,1132
-64,48,30,0,484,617,1131
-64,-64,23,0,314,362,699
64,-48,42,0,478,354,874
160,-96,24,0,381,251,656
160,-80,39,0,378,248,665
-64,64,56,0,462,349,867
64,-64,45,0,481,348,874
144,-96,16,0,398,290,704
176,-96,34,0,466,328,828
160,-112,41,0,443,325,809
128,-96,22,0,306,228,556
160,-128,12,0,287,253,552
160,-64,24,0,341,256,621
176,-64,23,0,273,289,585
144,-128,24,0,299,299,622
192,-128,21,0,247,193,461
192,-96,45,0,453,431,929
192,-80,21,0,325,261,607
176,-112,28,0,495,479,1002
144,-80,27,0,529,459,1015
176,-80,27,0,542,460,1029
144,-112,46,0,503,441,990
192,-112,22,0,418,374,814
128,-80,24,0,376,344,744
176,-128,21,0,413,427,861
128,-128,21,0,343,327,691
208,-96,21,0,265,217,503
144,-64,25,0,484,398,907
112,-80,21,0,261,227,509
128,-112,26,0,440,517,983
160,-48,24,0,357,325,706
160,-144,20,0,394,305,719
112,-96,20,0,314,313,647
192,-64,28,0,444,337,809
128,-64,25,0,435,359,819
176,-48,25,0,263,262,550
144,-48,24,0,319,216,559
208,-112,14,0,347,198,559
112,-64,23,0,258,192,473
208,-80,22,0,452,353,827
96,-96,24,0,265,203,492
192,-144,41,0,307,309,657
112,-112,15,0,439,381,835
144,-144,18,5,456,419,898
112,-128,22,0,256,416,694
176,-144,15,0,444,420,879
128,-144,15,0,445,404,864
144,-32,19,0,259,251,529
224,-80,25,0,338,308,671
128,-48,27,0,505,422,954
192,-48,25,0,414,449,888
160,-160,24,0,356,344,724
208,-128,46,0,460,455,961
224,-96,22,0,383,353,758
224,-112,13,0,290,299,602
208,-64,21,0,445,396,862
160,-32,15,0,397,383,795
176,-32,9,0,242,198,449
176,-160,13,0,412,359,784
144,-160,23,0,417,360,800
96,-80,13,0,352,245,610
112,-144,38,0,256,181,475
96,-112,45,0,336,304,685
208,-48,24,0,356,283,663
192,-160,22,0,274,197,493
128,-32,14,0,278,262,554
96,-144,10,0,195,234,439
112,-160,17,0,266,279,562
208,-144,32,0,426,323,781
208,-32,11,0,300,281,592
224,-128,27,0,404,331,762
96,-160,19,0,255,260,534
112,-48,21,0,405,413,839
96,-128,38,0,352,307,697
96,-32,16,0,281,231,528
112,-32,30,0,350,285,665
192,-32,41,0,370,307,718
96,-48,23,0,378,286,687
208,-160,38,0,331,237,606
96,-64,20,0,436,375,831
128,-160,24,0,510,279,813
224,-48,50,0,396,170,616
224,-144,24,0,451,215,690
224,-64,26,0,431,264,721
224,-160,22,0,325,47,394
224,-32,23,0,308,31,362
224,-176,21,0,104,111,236
208,-176,21,0,101,115,237
176,-176,15,0,110,123,248
192,-176,20,0,118,114,252
96,-176,20,0,123,123,266
160,-176,23,0,126,119,268
128,-176,20,0,141,108,269
112,-176,15,0,131,124,270
144,-176,23,0,148,99,270
112,-176,12,0,62,42,116
160,-176,13,0,65,43,121
128,-176,12,0,66,43,121
144,-176,13,0,75,37,125
176,-16,20,0,104,113,237
128,-16,13,0,110,118,241
192,-16,14,0,108,120,242
224,-16,19,0,120,119,258
160,-16,19,0,116,125,260
144,-16,20,0,124,118,262
112,-16,14,0,125,124,263
208,-16,20,0,119,124,263
96,-16,21,0,172,72,265
0,-48,41,0,283,234,558
-48,0,88,0,283,274,645
0,48,61,0,290,344,695
0,-16,93,0,266,341,700
16,-16,117,0,376,331,824
-16,0,121,0,361,415,897
-32,0,119,0,434,349,902
-16,16,130,0,387,389,906
32,-16,119,0,443,400,962
0,-32,43,0,351,658,1052
48,16,75,0,404,665,1144
16,48,74,0,522,636,1232
16,32,107,0,565,593,1265
16,-32,118,0,456,693,1267
0,32,59,0,558,666,1283
-16,-48,19,3,302,356,680
-16,48,23,0,370,381,774
32,16,110,0,615,634,1359
16,-48,11,0,253,271,535
0,16,78,29,546,716,1369
-32,32,88,0,591,706,1385
0,0,65,0,634,781,1480
48,0,57,0,667,763,1487
-48,16,57,0,713,764,1534
-16,32,125,0,701,744,1570
32,32,88,0,612,903,1603
48,-16,27,0,402,484,913
-32,16,57,0,708,873,1638
32,0,120,0,735,809,1664
-32,48,17,0,376,372,765
32,-48,26,0,346,334,706
-48,-16,41,0,474,501,1016
-16,-32,141,0,761,830,1732
16,16,84,0,781,869,1734
-16,-16,85,0,783,868,1736
32,-32,90,0,826,823,1739
-32,-48,22,0,451,356,829
-32,-32,83,0,752,919,1754
48,-32,25,6,418,394,843
16,0,120,0,833,833,1786
-32,-16,139,0,913,849,1901
64,0,28,0,346,241,615
0,-64,20,0,388,283,691
-16,-64,27,0,408,259,694
-64,32,39,0,317,328,684
64,-32,42,0,372,305,719
48,48,19,0,336,413,768
64,32,29,0,320,293,642
48,32,47,0,617,607,1271
-32,-64,26,0,367,351,744
-48,32,31,0,660,609,1300
-48,64,21,0,391,369,781
-64,0,45,0,648,654,1347
0,64,25,0,726,589,1340
64,16,32,0,634,647,1313
64,-48,31,0,366,346,743
-64,-48,19,0,320,337,676
16,-64,27,0,710,641,1378
48,-64,20,0,304,378,702
32,48,34,0,890,888,1812
-64,16,31,0,657,750,1438
64,48,22,0,334,261,617
-64,-64,21,0,242,337,600
-48,-32,19,0,904,855,1778
64,-16,35,0,801,734,1570
-16,64,44,0,817,827,1688
48,-48,43,0,644,764,1451
-48,48,61,0,711,755,1527
-64,64,22,0,449,349,820
-64,-16,62,0,762,879,1703
-64,48,26,0,593,891,1510
64,-64,42,0,442,402,886
-48,-64,44,0,699,752,1495
-48,-48,31,0,821,853,1705
160,-80,28,0,437,387,852
16,64,65,0,896,870,1831
176,-96,24,0,349,304,677
144,-64,30,0,371,296,697
32,-64,46,0,867,778,1691
192,-80,40,0,348,277,665
48,64,34,0,830,709,1573
160,-64,22,0,446,428,896
144,-112,24,0,318,227,569
32,64,35,0,892,938,1865
160,-112,15,0,432,295,742
64,64,32,0,714,553,1299
-32,64,74,0,1004,1006,2084
-64,-32,77,0,972,1045,2094
128,-64,29,0,373,294,696
160,-32,20,0,273,290,583
176,-32,17,0,211,277,505
112,-80,21,0,279,323,623
144,-96,28,0,700,544,1272
208,-80,21,0,318,292,631
176,-80,18,0,824,718,1560
128,-112,30,0,332,413,775
144,-80,30,0,793,638,1461
144,-128,34,0,274,235,543
144,-32,19,0,310,314,643
160,-96,32,0,805,693,1530
160,-48,33,0,675,720,1428
176,-64,28,0,689,945,1662
192,-96,29,0,569,695,1293
128,-96,14,4,633,613,1264
144,-48,19,0,644,590,1253
176,-48,25,0,609,746,1380
192,-112,17,0,551,596,1164
192,-32,35,0,225,244,504
176,-112,31,0,696,749,1476
192,-128,12,0,290,276,578
112,-96,25,0,373,419,817
128,-80,61,0,802,794,1657
208,-48,26,0,275,279,580
112,-112,14,0,269,258,541
192,-64,31,0,692,626,1349
208,-112,29,0,389,308,726
128,-48,26,0,702,684,1412
160,-144,37,0,292,285,614
160,-16,22,0,331,332,685
192,-48,34,0,715,753,1502
112,-64,14,0,757,680,1451
224,-64,43,0,399,409,851
176,-128,29,0,610,623,1262
208,-32,30,0,265,230,525
208,-64,33,0,789,747,1569
208,-96,28,0,766,642,1436
192,-144,27,0,257,217,501
128,-144,36,0,266,227,529
160,-128,29,0,795,991,1815
208,-128,24,0,319,335,678
112,-48,22,0,508,668,1198
192,-16,21,0,293,302,616
128,-128,33,0,741,638,1412
224,-112,17,0,345,366,728
224,-48,26,0,337,277,640
128,-32,33,0,774,767,1574
144,-144,29,0,642,596,1267
96,-128,17,0,229,228,474
96,-80,26,0,787,601,1414
176,-144,50,0,624,558,1232
224,-80,45,0,751,609,1405
96,-32,42,0,359,336,737
112,-128,32,0,459,618,1109
224,-96,16,0,695,505,1216
176,-16,30,0,598,538,1166
96,-96,31,0,665,484,1180
112,-32,35,0,664,401,1100
96,-64,29,0,619,584,1232
128,-16,28,0,592,393,1013
144,-16,21,0,736,559,1316
96,-144,11,0,270,259,540
208,-16,13,0,364,289,666
96,-48,44,0,683,367,1094
96,-112,17,0,634,307,958
224,-16,14,0,315,192,521
112,-144,33,0,614,207,854
112,-16,27,0,655,218,900
208,-144,29,0,526,148,703
96,-16,44,0,353,222,619
224,-32,25,0,515,158,698
224,-128,27,0,541,169,737
224,-144,31,0,458,87,576
240,-32,14,0,89,114,217
240,-96,13,0,95,117,225
240,-16,14,0,94,121,229
240,-144,13,0,110,117,240
240,-112,13,0,103,134,250
240,-128,15,0,137,100,252
240,-80,16,0,137,100,253
240,-48,16,0,143,109,268
240,-64,16,0,148,105,269
240,-160,19,0,111,118,248
208,-160,19,0,109,120,248
224,-160,19,0,106,129,254
192,-160,19,0,121,122,262
128,-160,19,0,124,123,266
160,-160,21,0,118,130,269
176,-160,20,0,121,129,270
144,-160,21,0,132,119,272
112,-160,14,0,125,133,272
96,-160,6,0,32,7,45
208,-176,18,0,97,119,234
224,-176,18,0,98,129,245
192,-176,34,0,99,123,256
176,-176,18,0,111,129,258
160,-176,18,0,116,139,273
96,-176,20,0,123,132,275
128,-176,34,0,126,117,277
144,-176,20,0,139,117,276
112,-176,20,0,131,127,278
128,0,18,0,99,105,222
112,0,24,0,93,115,232
96,0,19,0,114,119,252
224,0,18,0,117,118,253
176,0,22,0,112,122,256
160,0,23,0,109,124,256
192,0,19,0,132,111,262
144,0,23,0,115,126,264
208,0,19,0,145,104,268
0,-32,17,0,169,186,372
0,32,32,0,205,241,478
0,16,30,1,229,250,510
0,0,43,0,240,308,591
16,16,26,0,250,316,592
16,0,41,0,275,293,609
0,-16,59,0,243,348,650
-16,-16,42,0,283,362,687
32,0,57,0,295,339,691
-16,16,49,0,312,333,694
16,-32,15,0,234,457,706
32,16,23,0,336,373,732
-16,0,59,0,322,352,733
16,32,23,0,359,396,778
-32,0,43,0,405,358,806
32,-16,51,0,428,391,870
-16,32,24,0,399,457,880
-32,16,48,0,455,493,996
32,32,22,0,270,247,539
16,-16,79,0,521,466,1066
-16,-32,23,0,382,288,693
-32,-16,55,0,557,454,1066
32,-32,25,0,354,245,624
0,48,22,0,274,288,584
-32,32,23,0,345,301,669
-32,-32,26,0,340,306,672
-48,0,17,0,300,241,558
48,0,43,0,317,258,618
-48,16,28,0,268,231,527
0,-48,23,0,284,280,587
-16,-48,22,0,303,274,599
48,16,14,0,255,245,514
16,48,17,0,354,224,595
16,-48,36,0,380,302,718
48,32,35,0,242,233,510
32,48,22,0,297,315,634
32,-48,15,0,386,366,767
-48,-32,39,0,378,327,744
48,-16,31,0,514,487,1032
-48,32,28,0,261,275,564
0,64,29,0,272,261,562
64,0,23,0,247,294,564
48,-32,23,0,322,311,656
-16,48,25,0,499,490,1014
-48,-16,43,0,594,540,1177
-64,0,20,0,311,312,643
64,-16,30,0,318,298,646
-64,16,23,0,266,275,564
0,-64,22,0,290,352,664
-32,-48,38,0,461,469,968
-32,48,44,0,462,451,957
-64,-16,32,0,404,340,776
16,64,16,0,345,318,679
64,16,34,0,386,297,717
16,-64,31,0,340,233,604
48,-48,15,0,312,257,584
-16,64,27,0,374,278,679
-48,48,23,0,302,269,594
64,32,19,0,261,220,500
-32,64,24,0,337,296,657
64,-32,33,0,367,276,676
-48,-48,23,0,342,329,694
-64,32,17,5,290,308,620
-64,-32,34,0,332,291,657
32,64,22,0,341,333,696
64,48,22,0,360,248,630
-48,-64,32,0,290,259,581
-16,-64,28,0,486,402,916
32,-64,40,0,439,306,785
48,48,39,0,386,473,898
-32,-64,36,0,480,300,816
-48,64,27,0,357,254,638
-64,-48,22,0,398,282,702
48,64,29,0,424,143,596
48,-64,22,0,301,240,563
-64,-64,12,0,222,126,360
64,64,32,0,217,54,303
-64,48,13,0,269,119,401
-64,64,24,0,288,41,353
-48,-80,28,0,167,168,363
-80,-64,32,0,175,165,372
-80,-80,29,0,177,174,380
-64,-80,28,0,185,200,413
-32,-80,51,0,220,202,473
0,-80,33,0,230,224,487
-16,-80,34,0,230,232,496
-80,-48,49,0,258,196,503
48,-80,45,0,242,227,514
-80,-32,52,0,296,173,521
16,-80,33,0,289,215,537
-80,-16,53,0,267,218,538
-80,48,46,0,267,220,533
-80,0,53,0,357,139,549
32,-80,52,0,368,130,550
-80,16,53,0,364,139,556
-80,32,51,0,346,166,563
-80,64,7,0,35,11,53
48,80,18,0,106,128,252
16,80,14,0,118,123,255
0,80,18,0,117,131,266
64,80,18,0,117,134,269
-48,80,14,0,135,131,280
32,80,14,0,127,149,290
-64,80,21,0,136,133,290
-32,80,14,0,136,140,290
-16,80,20,0,153,118,291
-80,80,6,0,37,7,50
-96,80,13,0,87,77,177
-96,64,19,0,95,107,221
-96,-48,14,0,104,114,232
-96,48,14,0,119,106,239
-96,-16,15,0,146,91,252
-96,-32,21,0,152,87,260
-96,0,23,0,150,87,260
-96,32,23,0,133,105,261
-96,16,34,0,190,41,265
-96,-64,6,0,35,6,47
32,16,109,2,628,382,1121
48,16,66,0,660,454,1180
16,-48,115,0,635,463,1213
-48,16,94,0,730,476,1300
16,-32,91,0,671,558,1320
16,16,90,0,749,552,1391
0,-16,96,0,696,604,1396
32,32,89,0,691,614,1394
-16,32,107,0,794,631,1532
-32,0,119,0,857,589,1565
-32,16,123,0,808,663,1594
32,0,118,0,854,681,1653
0,-32,91,0,819,745,1655
-32,-16,133,0,895,627,1655
48,0,89,0,881,684,1654
16,-16,140,0,830,706,1676
-16,48,82,0,883,714,1679
-32,-32,137,0,836,707,1680
0,-48,67,0,969,647,1683
-16,-32,108,0,899,701,1708
16,32,106,0,971,635,1712
0,32,82,0,986,690,1758
0,16,106,1,975,732,1814
16,0,95,0,1026,723,1844
0,48,82,0,1016,815,1913
-48,0,107,0,1429,747,2283
16,48,82,0,1446,768,2296
-16,16,107,4,1391,832,2334
-32,32,88,0,1436,816,2340
-16,-16,128,2,1401,851,2382
32,-16,141,0,1417,854,2412
32,-32,105,0,1546,780,2431
0,0,134,0,1455,887,2476
-16,-48,66,6,1587,905,2564
-32,48,27,0,1073,618,1718
48,-16,131,1,1428,1050,2610
-48,32,14,0,744,481,1239
32,-48,30,0,884,559,1473
-32,-48,30,0,1002,562,1594
48,-32,25,0,953,562,1540
48,32,22,0,843,583,1448
-64,16,46,0,666,436,1148
64,0,31,0,793,530,1354
16,-64,25,0,773,470,1268
0,64,28,0,935,491,1454
64,16,30,0,853,471,1354
-64,0,16,0,1002,581,1599
32,48,52,0,1081,681,1814
-16,0,119,0,1802,1198,3119
16,64,39,0,837,559,1435
0,-64,49,0,911,645,1605
-48,-16,136,0,1848,1317,3301
-48,-32,38,1,1197,689,1925
64,-16,45,0,1066,546,1657
-64,32,29,0,1155,649,1833
48,-48,27,0,1195,723,1945
64,48,13,0,655,366,1034
-48,-48,28,0,1262,766,2056
-48,48,25,0,1302,709,2036
64,-32,52,0,1259,737,2048
-16,64,52,0,1412,828,2292
-64,-16,31,0,1406,843,2280
48,48,14,0,1255,991,2260
-64,-48,16,0,837,588,1441
48,64,27,0,901,548,1476
64,64,19,0,755,411,1185
-64,-64,26,0,732,603,1361
96,112,13,2,739,460,1214
64,32,33,0,1073,642,1748
-16,-64,38,0,1585,1022,2645
112,96,22,0,707,439,1168
112,112,14,0,716,643,1373
-64,64,31,0,949,606,1586
80,112,12,0,741,573,1326
96,128,14,6,831,590,1441
48,-64,50,0,957,781,1788
80,128,43,0,728,508,1279
64,-64,62,0,969,633,1664
-32,64,34,0,1389,833,2256
96,96,30,0,828,686,1544
96,144,36,0,721,502,1259
128,112,14,0,819,501,1334
32,-64,36,7,1550,908,2501
-32,-64,17,0,1597,959,2573
-48,-64,62,0,1401,932,2395
-48,64,37,0,1614,941,2592
80,80,16,0,756,488,1260
64,144,37,0,565,345,947
-64,-32,49,1,1750,976,2776
-64,48,33,0,1548,1151,2732
64,-48,48,0,1602,992,2642
32,64,32,0,1801,1093,2926
64,80,14,0,687,514,1215
128,144,15,0,707,496,1218
128,96,21,0,884,627,1532
64,112,18,0,1015,658,1691
96,80,40,0,974,688,1702
128,80,25,0,927,483,1435
112,80,32,0,1013,689,1734
80,144,40,0,901,606,1547
80,96,23,0,1337,910,2270
112,128,37,1,1495,946,2479
48,112,23,0,703,536,1262
112,144,18,0,1101,673,1792
64,96,26,0,1029,614,1669
64,128,32,0,955,658,1645
128,128,32,0,906,700,1638
80,64,31,0,775,491,1297
48,128,27,0,919,534,1480
80,160,17,0,846,520,1383
144,128,26,0,901,496,1423
144,112,20,1,978,532,1531
112,160,15,0,871,564,1450
96,160,29,0,1013,693,1735
64,160,23,0,770,504,1297
144,96,28,0,824,540,1392
64,64,16,0,805,426,1247
112,64,15,0,917,622,1554
48,144,46,0,675,349,1070
48,80,31,0,780,426,1237
48,96,21,0,1113,693,1827
96,64,54,0,1358,811,2223
160,128,15,0,760,434,1209
80,48,31,0,767,389,1187
48,160,31,0,578,355,964
64,48,21,0,608,363,992
128,48,19,0,707,342,1068
128,64,51,0,1329,689,2069
32,128,15,0,866,557,1438
32,160,20,0,610,478,1108
160,96,33,0,902,611,1546
144,80,17,0,1450,761,2228
144,144,58,0,1199,731,1988
144,176,14,0,725,367,1106
112,48,57,0,1013,583,1653
160,144,23,0,714,506,1243
112,176,16,0,952,623,1591
80,176,45,0,1088,604,1737
32,144,16,0,978,499,1493
96,176,32,0,1196,800,2028
128,160,21,0,1419,812,2252
64,176,29,0,871,476,1376
144,64,38,0,981,557,1576
160,80,34,0,956,577,1567
160,112,23,0,1216,746,1985
144,48,31,0,744,318,1093
160,64,22,0,819,453,1294
48,176,31,2,858,476,1367
32,96,34,0,1160,502,1696
32,80,26,0,889,503,1418
128,176,24,0,922,495,1441
160,160,24,0,659,295,978
32,112,31,0,1508,645,2184
48,64,24,0,1317,398,1739
48,48,24,0,895,496,1415
144,160,57,0,1328,361,1746
96,48,39,0,1478,579,2096
32,64,22,0,976,224,1222
160,176,17,0,651,151,819
160,48,27,0,665,152,844
32,176,18,0,802,51,871
32,48,37,0,882,64,983
112,192,9,0,167,110,286
96,192,12,0,183,132,327
128,192,10,0,189,130,329
144,192,11,0,198,123,332
48,192,12,0,210,126,348
80,192,17,0,205,129,351
160,192,12,0,215,124,351
64,192,11,0,211,130,352
32,192,11,0,209,138,358
